Zone ID,Zone name,l080001,l080020,l080115,l080134,l080172
01AAFA,Aldersgate                      ,1152,847,2,42,305
01AAFB,Aldgate                         ,0,0,0,0,0
01AAFC,Bassishaw                       ,0,0,0,0,0
01AAFD,Billingsgate                    ,0,0,0,0,0
01AAFE,Bishopsgate                     ,0,0,0,0,0
01AAFF,Bread Street                    ,0,0,0,0,0
01AAFG,Bridge                          ,0,0,0,0,0
01AAFH,Broad Street                    ,0,0,0,0,0
01AAFJ,Candlewick                      ,0,0,0,0,0
01AAFK,Castle Baynard                  ,0,0,0,0,0
01AAFL,Cheap                           ,0,0,0,0,0
01AAFM,Coleman Street                  ,0,0,0,0,0
01AAFN,Cordwainer                      ,0,0,0,0,0
01AAFP,Cornhill                        ,0,0,0,0,0
01AAFQ,Cripplegate                     ,1474,1073,2,69,401
01AAFR,Dowgate                         ,0,0,0,0,0
01AAFS,Farringdon Within               ,0,0,0,0,0
01AAFT,Farringdon Without              ,0,0,0,0,0
01AAFU,Langbourn                       ,0,0,0,0,0
01AAFW,Lime Street                     ,0,0,0,0,0
01AAFX,Portsoken                       ,0,0,0,0,0
01AAFY,Queenhithe                      ,0,0,0,0,0
01AAFZ,Tower                           ,0,0,0,0,0
01AAGA,Vintry                          ,0,0,0,0,0
01AAGB,Walbrook                        ,1256,884,7,64,372
01AASS,Shipping                        ,0,0,0,0,0
01ABFA,Adelaide                        ,7122,4177,45,448,2945
01ABFB,Belsize                         ,6974,4824,37,433,2150
01ABFC,Bloomsbury                      ,6081,3918,56,397,2163
01ABFD,Brunswick                       ,3637,2318,46,243,1319
01ABFE,Camden                          ,5792,3990,68,624,1802
01ABFF,Castlehaven                     ,4365,2697,41,453,1668
01ABFG,Caversham                       ,4882,2898,45,398,1984
01ABFH,Chalk Farm                      ,4336,2901,24,335,1435
01ABFJ,Fitzjohns                       ,4543,2966,15,252,1577
01ABFK,Fortune Green                   ,4400,2953,23,310,1447
01ABFL,Frognal                         ,4962,3031,22,216,1931
01ABFM,Gospel Oak                      ,4789,2769,57,412,2020
01ABFN,Grafton                         ,4619,2697,61,456,1922
01ABFP,Hampstead Town                  ,4341,2825,29,197,1516
01ABFQ,Highgate                        ,8597,5333,80,560,3264
01ABFR,Holborn                         ,4968,3015,36,472,1953
01ABFS,Kilburn                         ,7979,5344,61,869,2635
01ABFT,King's Cross                    ,5689,3498,82,768,2191
01ABFU,Priory                          ,5392,3073,59,550,2319
01ABFW,Regent's Park                   ,7148,4158,54,610,2990
01ABFX,St.John's                       ,4895,3265,45,441,1630
01ABFY,St.Pancras                      ,3804,2230,45,448,1574
01ABFZ,Somers Town                     ,5323,3008,66,553,2315
01ABGA,South End                       ,5100,3263,44,382,1837
01ABGB,Swiss Cottage                   ,8069,5365,51,602,2704
01ABGC,West End                        ,5079,3717,26,443,1362
01ABSS,Shipping                        ,0,0,0,0,0
01ACFA,Brownswood                      ,5710,3748,51,735,1962
01ACFB,Chatham                         ,6620,3877,80,871,2743
01ACFC,Clissold                        ,7165,4659,85,945,2506
01ACFD,Dalston                         ,6198,3902,63,811,2296
01ACFE,De Beauvoir                     ,6829,4253,72,860,2576
01ACFF,Eastdown                        ,6951,4287,113,1192,2664
01ACFG,Haggerston                      ,4671,2708,62,714,1963
01ACFH,Homerton                        ,4987,3375,73,673,1612
01ACFJ,Kings Park                      ,4997,3077,81,846,1920
01ACFK,Leabridge                       ,6801,4247,76,948,2554
01ACFL,Moorfields                      ,4654,2675,30,584,1979
01ACFM,New River                       ,7647,4119,91,1001,3528
01ACFN,North Defoe                     ,3961,2593,39,473,1368
01ACFP,Northfield                      ,6633,3831,86,862,2802
01ACFQ,Northwold                       ,6766,4286,116,997,2480
01ACFR,Queensbridge                    ,7637,4576,99,1227,3061
01ACFS,Rectory                         ,6550,4260,82,994,2290
01ACFT,South Defoe                     ,4121,2614,39,544,1507
01ACFU,Springfield                     ,7073,4009,112,907,3064
01ACFW,Victoria                        ,7682,4703,98,927,2979
01ACFX,Wenlock                         ,4880,2662,40,620,2218
01ACFY,Westdown                        ,4037,2748,49,671,1289
01ACFZ,Wick                            ,6842,4114,74,769,2728
01ACSS,Shipping                        ,0,0,0,0,0
01ADFA,Addison                         ,5813,4111,54,720,1702
01ADFB,Avonmore                        ,5342,3676,47,474,1666
01ADFC,Broadway                        ,4165,2487,20,317,1678
01ADFD,Brook Green                     ,6139,4338,40,490,1801
01ADFE,Colehill                        ,5077,3551,17,347,1526
01ADFF,College Park and Old Oak        ,6596,4028,81,655,2568
01ADFG,Coningham                       ,8455,5812,92,1059,2643
01ADFH,Crabtree                        ,4314,2809,17,276,1505
01ADFJ,Eel Brook                       ,4778,3256,22,437,1522
01ADFK,Gibbs Green                     ,5757,4131,60,637,1626
01ADFL,Grove                           ,5106,3607,34,436,1499
01ADFM,Margravine                      ,4756,3248,39,393,1508
01ADFN,Normand                         ,5017,3194,39,423,1823
01ADFP,Palace                          ,4589,2871,11,280,1718
01ADFQ,Ravenscourt                     ,4568,3053,26,333,1515
01ADFR,Sands End                       ,5398,3600,19,468,1798
01ADFS,Sherbrooke                      ,4087,2769,17,295,1318
01ADFT,Starch Green                    ,4696,3200,20,321,1496
01ADFU,Sulivan                         ,4740,3062,26,341,1678
01ADFW,Town                            ,5403,3773,22,341,1630
01ADFX,Walham                          ,5842,3755,40,455,2087
01ADFY,White City and Shepherds Bush   ,7422,4642,83,1019,2780
01ADFZ,Wormholt                        ,6733,4207,55,595,2526
01ADSS,Shipping                        ,0,0,0,0,0
01AEFA,Alexandra                       ,7233,5009,43,520,2224
01AEFB,Archway                         ,5754,4254,37,445,1500
01AEFC,Bowes Park                      ,9309,5954,80,1046,3355
01AEFD,Bruce Grove                     ,8504,5581,122,1290,2923
01AEFE,Coleraine                       ,8385,5269,130,1270,3116
01AEFF,Crouch End                      ,7439,5363,74,747,2076
01AEFG,Fortis Green                    ,7721,5012,52,546,2709
01AEFH,Green Lanes                     ,6443,4167,80,928,2276
01AEFJ,Harringay                       ,8676,5926,91,1266,2750
01AEFK,High Cross                      ,5479,3394,87,776,2085
01AEFL,Highgate                        ,5363,3211,30,273,2152
01AEFM,Hornsey Central                 ,5692,3626,70,564,2066
01AEFN,Hornsey Vale                    ,5276,3870,46,559,1406
01AEFP,Muswell Hill                    ,8602,5963,42,675,2639
01AEFQ,Noel Park                       ,8688,5212,113,1087,3476
01AEFR,Park                            ,5138,3154,62,680,1984
01AEFS,Seven Sisters                   ,5151,3261,64,708,1890
01AEFT,South Hornsey                   ,5405,3849,56,634,1556
01AEFU,South Tottenham                 ,5820,3657,82,759,2163
01AEFW,Tottenham Central               ,8441,5318,129,1051,3123
01AEFX,West Green                      ,8983,5807,150,1145,3176
01AEFY,White Hart Lane                 ,7328,3937,66,840,3391
01AEFZ,Woodside                        ,7834,4983,82,873,2851
01AESS,Shipping                        ,0,0,0,0,0
01AFFA,Barnsbury                       ,7594,4914,55,840,2680
01AFFB,Bunhill                         ,6429,3563,58,593,2866
01AFFC,Canonbury East                  ,5655,3616,60,623,2039
01AFFD,Canonbury West                  ,4689,2768,25,427,1921
01AFFE,Clerkenwell                     ,7902,4881,62,882,3021
01AFFF,Gillespie                       ,4846,3266,52,463,1580
01AFFG,Highbury                        ,7912,5272,62,857,2640
01AFFH,Highview                        ,4414,2857,61,581,1557
01AFFJ,Hillmarton                      ,5687,3459,42,550,2228
01AFFK,Hillrise                        ,7461,4851,48,738,2610
01AFFL,Holloway                        ,7084,4273,61,750,2811
01AFFM,Junction                        ,7593,4782,54,787,2811
01AFFN,Mildmay                         ,9339,5959,97,1013,3380
01AFFP,Quadrant                        ,5731,3512,48,541,2219
01AFFQ,St.George's                     ,7913,5006,66,871,2907
01AFFR,St.Mary                         ,6200,4143,54,581,2057
01AFFS,St.Peter                        ,7130,4581,41,733,2549
01AFFT,Sussex                          ,5597,3598,53,666,1999
01AFFU,Thornhill                       ,5383,3414,49,722,1969
01AFFW,Tollington                      ,8666,5485,65,1121,3181
01AFSS,Shipping                        ,0,0,0,0,0
01AGFA,Abingdon                        ,6866,4347,59,442,2519
01AGFB,Avondale                        ,6253,3799,47,730,2454
01AGFC,Brompton                        ,3535,2299,25,150,1236
01AGFD,Campden                         ,5844,3727,35,258,2117
01AGFE,Cheyne                          ,4793,2901,13,216,1892
01AGFF,Church                          ,3854,2123,20,216,1731
01AGFG,Colville                        ,6170,4300,63,738,1870
01AGFH,Courtfield                      ,6475,4671,34,446,1804
01AGFJ,Earls Court                     ,8471,5993,69,858,2478
01AGFK,Golborne                        ,6014,3779,71,913,2235
01AGFL,Hans Town                       ,6157,3716,20,273,2441
01AGFM,Holland                         ,7017,4372,36,452,2645
01AGFN,Kelfield                        ,5200,3489,36,494,1711
01AGFP,Norland                         ,3692,2482,7,183,1210
01AGFQ,North Stanley                   ,4410,2760,22,269,1650
01AGFR,Pembridge                       ,6361,4474,44,442,1887
01AGFS,Queens Gate                     ,7027,4444,31,362,2583
01AGFT,Redcliffe                       ,6535,4339,41,483,2196
01AGFU,Royal Hospital                  ,4344,2511,11,153,1833
01AGFW,St.Charles                      ,4418,2570,35,467,1848
01AGFX,South Stanley                   ,5169,3013,41,477,2156
01AGSS,Shipping                        ,0,0,0,0,0
01AHFA,Angell                          ,8274,5148,108,1292,3126
01AHFB,Bishop's                        ,7925,4752,94,839,3173
01AHFC,Clapham Park                    ,9907,6648,56,915,3259
01AHFD,Clapham Town                    ,9631,6556,92,1067,3075
01AHFE,Ferndale                        ,10041,6896,145,1461,3145
01AHFF,Gipsy Hill                      ,9424,5962,68,903,3462
01AHFG,Herne Hill                      ,8903,6069,76,1016,2834
01AHFH,Knight's Hill                   ,9846,6149,72,954,3697
01AHFJ,Larkhall                        ,10297,6623,115,1356,3674
01AHFK,Oval                            ,9263,6150,63,1106,3113
01AHFL,Prince's                        ,6579,4121,69,686,2458
01AHFM,St.Leonard's                    ,8847,6009,50,756,2838
01AHFN,St.Martin's                     ,8210,5243,70,912,2967
01AHFP,Stockwell                       ,8532,5429,64,1121,3103
01AHFQ,Streatham Hill                  ,9826,6288,56,900,3538
01AHFR,Streatham South                 ,8808,5759,61,703,3049
01AHFS,Streatham Wells                 ,10523,6956,80,942,3567
01AHFT,Thornton                        ,6419,4282,57,529,2137
01AHFU,Thurlow Park                    ,5885,3861,53,480,2024
01AHFW,Town Hall                       ,10073,6760,138,1272,3313
01AHFX,Tulse Hill                      ,9333,6633,123,1362,2700
01AHFY,Vassall                         ,10626,6614,146,1489,4012
01AHSS,Shipping                        ,0,0,0,0,0
01AJFA,Bellingham                      ,6159,3406,41,623,2753
01AJFB,Blackheath                      ,5351,3422,27,458,1929
01AJFC,Blythe Hill                     ,5568,3868,38,386,1700
01AJFD,Catford                         ,6297,3982,31,430,2315
01AJFE,Churchdown                      ,7403,4062,38,557,3341
01AJFF,Crofton Park                    ,8565,5820,57,746,2745
01AJFG,Downham                         ,7523,3972,39,516,3551
01AJFH,Drake                           ,8383,5564,84,890,2819
01AJFJ,Evelyn                          ,7369,4377,117,1105,2992
01AJFK,Forest Hill                     ,5368,3340,33,471,2028
01AJFL,Grinling Gibbons                ,7682,5009,98,1068,2673
01AJFM,Grove Park                      ,5161,2924,45,385,2237
01AJFN,Hither Green                    ,8805,5832,61,938,2973
01AJFP,Horniman                        ,8134,5431,32,585,2703
01AJFQ,Ladywell                        ,8166,5490,71,783,2676
01AJFR,Manor Lee                       ,6058,4139,51,454,1919
01AJFS,Marlowe                         ,7672,4930,114,1135,2742
01AJFT,Pepys                           ,8315,5736,96,1023,2579
01AJFU,Perry Hill                      ,8708,5658,45,626,3050
01AJFW,Rushey Green                    ,6436,4290,43,589,2146
01AJFX,St.Andrew                       ,5893,3968,31,384,1925
01AJFY,St.Margaret                     ,5636,3554,22,362,2082
01AJFZ,St.Mildred                      ,8740,5440,35,527,3300
01AJGA,Sydenham East                   ,7913,4923,54,726,2990
01AJGB,Sydenham West                   ,8296,5283,60,688,3013
01AJGC,Whitefoot                       ,5377,2996,31,464,2381
01AJSS,Shipping                        ,0,0,0,0,0
01AKFA,Beckton                         ,3948,2093,37,497,1855
01AKFB,Bemersyde                       ,4668,2876,42,387,1792
01AKFC,Canning Town and Grange         ,5910,3330,47,670,2580
01AKFD,Castle                          ,5593,3135,71,632,2458
01AKFE,Central                         ,5874,3461,64,722,2413
01AKFF,Custom House and Silvertown     ,9026,5594,94,1112,3432
01AKFG,Forest Gate                     ,7337,4773,67,803,2564
01AKFH,Greatfield                      ,8294,5129,74,578,3165
01AKFJ,Hudsons                         ,7278,4214,58,726,3064
01AKFK,Kensington                      ,5688,3237,68,749,2451
01AKFL,Little Ilford                   ,7735,4503,90,960,3232
01AKFM,Manor Park                      ,8442,4844,88,912,3598
01AKFN,Monega                          ,5670,3440,61,798,2230
01AKFP,New Town                        ,5119,2904,66,545,2215
01AKFQ,Ordnance                        ,3919,2107,40,599,1812
01AKFR,Park                            ,7509,4672,82,987,2837
01AKFS,Plaistow                        ,6439,3724,56,755,2715
01AKFT,Plashet                         ,8140,4659,79,1000,3481
01AKFU,St.Stephens                     ,5278,2971,53,702,2307
01AKFW,South                           ,11542,7153,94,1026,4389
01AKFX,Stratford                       ,5017,3135,49,622,1882
01AKFY,Upton                           ,7460,4411,96,963,3049
01AKFZ,Wall End                        ,8482,5108,96,930,3374
01AKGA,West Ham                        ,5945,3569,64,660,2376
01AKSS,Shipping                        ,0,0,0,0,0
01ALFA,Abbey                           ,4832,3032,37,566,1800
01ALFB,Alleyn                          ,5559,3734,38,456,1825
01ALFC,Barset                          ,4812,2918,48,513,1894
01ALFD,Bellenden                       ,8586,5957,79,877,2629
01ALFE,Bricklayers                     ,6730,4141,66,700,2589
01ALFF,Browning                        ,7414,4275,62,957,3139
01ALFG,Brunswick                       ,7723,4691,94,979,3032
01ALFH,Burgess                         ,4447,2718,52,546,1729
01ALFJ,Cathedral                       ,5174,3107,31,539,2067
01ALFK,Chaucer                         ,7415,4469,73,960,2946
01ALFL,College                         ,6169,3753,28,332,2416
01ALFM,Consort                         ,5187,3114,69,763,2073
01ALFN,Dockyard                        ,10683,7321,77,1055,3362
01ALFP,Faraday                         ,9226,5452,101,1268,3774
01ALFQ,Friary                          ,6378,3964,90,1008,2414
01ALFR,Liddle                          ,7729,4753,149,1475,2976
01ALFS,Lyndhurst                       ,8865,5555,108,876,3310
01ALFT,Newington                       ,8833,5169,70,981,3664
01ALFU,Riverside                       ,7547,4567,51,774,2980
01ALFW,Rotherhithe                     ,6015,3445,59,687,2570
01ALFX,Ruskin                          ,7797,4845,31,422,2952
01ALFY,Rye                             ,6640,4359,43,525,2281
01ALFZ,St.Giles                        ,8962,5709,100,1083,3253
01ALGA,The Lane                        ,5774,3424,65,673,2350
01ALGB,Waverley                        ,5532,3620,55,601,1912
01ALSS,Shipping                        ,0,0,0,0,0
01AMFA,Blackwall                       ,3587,1972,55,476,1615
01AMFB,Bow                             ,6290,3874,55,718,2416
01AMFC,Bromley                         ,7139,4180,117,964,2959
01AMFD,East India                      ,5164,2999,56,614,2165
01AMFE,Grove                           ,4163,2679,29,400,1484
01AMFF,Holy Trinity                    ,6960,3727,52,916,3233
01AMFG,Lansbury                        ,6309,3539,56,806,2770
01AMFH,Limehouse                       ,6306,3527,51,833,2779
01AMFJ,Millwall,10693,7214,89,1246,3479
01AMFK,Park                            ,4257,2276,35,449,1981
01AMFL,Redcoat                         ,5032,2720,63,597,2312
01AMFM,St.Dunstan's                    ,6911,3461,81,944,3450
01AMFN,St.James'                       ,4753,2631,35,525,2122
01AMFP,St.Katherine's                  ,10136,6347,71,1276,3789
01AMFQ,St.Mary's                       ,4216,2322,54,450,1894
01AMFR,St.Peter's                      ,7827,4689,74,985,3138
01AMFS,Shadwell                        ,7173,4204,63,931,2969
01AMFT,Spitalfields                    ,5782,2902,93,961,2880
01AMFU,Weavers                         ,7252,3929,58,978,3323
01AMSS,Shipping                        ,0,0,0,0,0
01ANFA,Balham                          ,9757,7083,46,705,2674
01ANFB,Bedford                         ,11022,7665,87,949,3357
01ANFC,Earlsfield                      ,7008,4843,37,606,2165
01ANFD,East Putney                     ,11178,7461,55,636,3717
01ANFE,Fairfield                       ,6256,4530,31,513,1726
01ANFF,Furzedown                       ,11479,7556,74,913,3923
01ANFG,Graveney                        ,11092,7648,79,1033,3444
01ANFH,Latchmere                       ,8759,5473,85,1029,3286
01ANFJ,Nightingale                     ,10173,6880,55,659,3293
01ANFK,Northcote                       ,9520,6906,28,623,2614
01ANFL,Parkside                        ,6369,4029,46,425,2340
01ANFM,Queenstown                      ,7091,4897,53,749,2194
01ANFN,Roehampton                      ,9499,5029,46,794,4470
01ANFP,St.John                         ,10086,7050,75,967,3036
01ANFQ,St.Mary's Park                  ,9770,6800,58,898,2970
01ANFR,Shaftesbury                     ,10919,7748,57,834,3171
01ANFS,Southfield                      ,10827,7534,41,650,3293
01ANFT,Springfield                     ,11527,7300,75,656,4227
01ANFU,Thamesfield                     ,10577,7246,28,577,3331
01ANFW,Tooting                         ,11150,7469,117,1040,3681
01ANFX,West Hill                       ,6800,4118,29,466,2682
01ANFY,West Putney                     ,10738,6132,43,594,4606
01ANSS,Shipping                        ,0,0,0,0,0
01APFA,Baker Street                    ,4102,2660,35,235,1442
01APFB,Bayswater                       ,8285,5183,71,712,3102
01APFC,Belgrave                        ,5075,3280,21,202,1795
01APFD,Bryanston                       ,4411,2607,50,279,1804
01APFE,Cavendish                       ,6214,4205,42,339,2009
01APFF,Churchill                       ,7528,4464,47,480,3064
01APFG,Church Street                   ,7958,4456,71,719,3502
01APFH,Hamilton Terrace                ,4961,2931,30,248,2030
01APFJ,Harrow Road                     ,9474,6416,92,1021,3058
01APFK,Hyde Park                       ,7273,4168,80,568,3105
01APFL,Knightsbridge                   ,4258,2446,20,151,1812
01APFM,Lancaster Gate                  ,9093,6168,120,873,2925
01APFN,Little Venice                   ,7600,5144,62,644,2456
01APFP,Lords                           ,5488,2909,29,237,2579
01APFQ,Maida Vale                      ,7175,4640,51,519,2535
01APFR,Millbank                        ,6131,3779,64,392,2352
01APFS,Queen's Park                    ,7793,4669,76,852,3124
01APFT,Regent's Park                   ,8433,4711,37,396,3722
01APFU,St.George's                     ,8347,5951,71,621,2396
01APFW,St.James'                       ,3541,2571,25,243,970
01APFX,Victoria                        ,4107,2768,26,334,1339
01APFY,Westbourne                      ,8399,5239,73,767,3160
01APFZ,West End                        ,5445,3615,28,376,1830
01APSS,Shipping                        ,0,0,0,0,0
02AQFA,Abbey                           ,7318,4510,61,734,2808
02AQFB,Alibon                          ,4519,2519,25,334,2000
02AQFC,Cambell                         ,7074,4251,37,498,2823
02AQFD,Chadwell Heath                  ,7061,4417,26,316,2644
02AQFE,Eastbrook                       ,7243,4550,30,410,2693
02AQFF,Eastbury                        ,4642,2605,21,302,2037
02AQFG,Fanshawe                        ,6731,3709,38,454,3022
02AQFH,Gascoigne                       ,6285,3641,40,652,2644
02AQFJ,Goresbrook                      ,5281,3147,25,407,2134
02AQFK,Heath                           ,7178,4190,34,479,2988
02AQFL,Longbridge                      ,6981,4177,17,269,2804
02AQFM,Manor                           ,4736,2504,25,285,2232
02AQFN,Marks Gate                      ,2041,1097,12,145,944
02AQFP,Parsloes                        ,5240,2894,20,328,2346
02AQFQ,River                           ,5099,3385,30,341,1714
02AQFR,Thames                          ,4449,2458,35,369,1991
02AQFS,Triptons                        ,7101,4036,30,430,3065
02AQFT,Valence                         ,6960,3710,26,460,3250
02AQFU,Village                         ,7570,4496,39,534,3074
02AQSS,Shipping                        ,0,0,0,0,0
02ARFA,Arkley                          ,12420,7567,69,610,4853
02ARFB,Brunswick Park                  ,11207,6916,57,506,4291
02ARFC,Burnt Oak                       ,10076,5977,72,743,4099
02ARFD,Childs Hill                     ,10611,6332,53,647,4279
02ARFE,Colindale                       ,11565,7414,109,837,4151
02ARFF,East Barnet                     ,11472,7555,56,508,3917
02ARFG,East Finchley                   ,12351,7799,71,805,4552
02ARFH,Edgware                         ,12136,7430,36,554,4706
02ARFJ,Finchley                        ,11576,7255,54,531,4321
02ARFK,Friern Barnet                   ,11771,7286,68,532,4485
02ARFL,Garden Suburb                   ,11543,6752,41,335,4791
02ARFM,Golders Green                   ,11754,6809,67,678,4945
02ARFN,Hadley                          ,13839,8998,47,537,4841
02ARFP,Hale                            ,10592,6626,48,453,3966
02ARFQ,Hendon                          ,12574,7406,70,636,5168
02ARFR,Mill Hill                       ,12192,7495,50,447,4697
02ARFS,St.Pauls                        ,11630,7301,62,618,4329
02ARFT,Totteridge                      ,12464,7486,41,456,4978
02ARFU,West Hendon                     ,11693,7271,72,681,4422
02ARFW,Woodhouse                       ,12784,8110,57,737,4674
02ARSS,Shipping                        ,0,0,0,0,0
02ASFA,Barnehurst                      ,4997,3324,20,182,1673
02ASFB,Barnehurst North                ,3223,2117,11,94,1106
02ASFC,Belvedere                       ,9845,6674,45,589,3171
02ASFD,Blackfen                        ,5381,3590,15,250,1791
02ASFE,Blendon and Penhill             ,7685,4978,29,268,2707
02ASFF,Bostall                         ,7645,4659,41,271,2986
02ASFG,Brampton                        ,8154,5029,51,281,3125
02ASFH,Christchurch                    ,8095,5139,35,344,2956
02ASFJ,Cray                            ,4336,2607,27,265,1729
02ASFK,Crayford                        ,9103,5955,47,502,3148
02ASFL,Danson                          ,7496,4764,32,343,2732
02ASFM,East Wickham                    ,8718,5464,37,417,3254
02ASFN,Erith                           ,8162,5116,50,596,3046
02ASFP,Falconwood                      ,2804,1807,10,131,997
02ASFQ,Lamorbey                        ,7992,5305,26,307,2687
02ASFR,North End                       ,8535,5500,49,593,3035
02ASFS,Northumberland Heath            ,8102,5175,38,365,2927
02ASFT,St. Mary's                      ,8778,5624,38,289,3154
02ASFU,St. Michael's                   ,8016,5280,38,323,2736
02ASFW,Sidcup East                     ,8874,5419,53,295,3455
02ASFX,Sidcup West                     ,8040,4994,23,272,3046
02ASFY,Thamesmead East                 ,10154,7112,107,1063,3042
02ASFZ,Upton                           ,8068,5063,28,399,3005
02ASSS,Shipping                        ,0,0,0,0,0
02ATFA,Alperton                        ,6674,4613,47,579,2061
02ATFB,Barham                          ,8951,5772,72,665,3179
02ATFC,Barnhill                        ,5603,3323,37,222,2280
02ATFD,Brentwater                      ,6780,4435,50,518,2345
02ATFE,Brondesbury Park                ,6907,4171,69,594,2736
02ATFF,Carlton                         ,4796,2883,56,621,1913
02ATFG,Chamberlayne                    ,6213,3894,43,446,2319
02ATFH,Church End                      ,5019,3363,42,513,1656
02ATFJ,Cricklewood                     ,6633,4236,47,627,2397
02ATFK,Fryent                          ,6392,4024,49,408,2368
02ATFL,Gladstone                       ,6574,4322,57,454,2252
02ATFM,Harlesden                       ,4761,3261,44,590,1500
02ATFN,Kensal Rise                     ,4956,3477,33,578,1479
02ATFP,Kenton                          ,7152,4421,46,253,2731
02ATFQ,Kilburn                         ,6423,4384,73,684,2039
02ATFR,Kingsbury                       ,6438,3914,37,376,2524
02ATFS,Manor                           ,5789,3907,48,546,1882
02ATFT,Mapesbury                       ,6134,4125,58,607,2009
02ATFU,Preston                         ,9823,6272,58,623,3551
02ATFW,Queensbury                      ,6659,4203,39,388,2456
02ATFX,Queens Park                     ,4795,3293,40,460,1502
02ATFY,Roe Green                       ,5424,3564,36,354,1860
02ATFZ,Roundwood                       ,5108,3245,54,665,1863
02ATGA,St. Andrew's                    ,5054,3130,66,592,1924
02ATGB,St. Raphael's                   ,7611,4715,94,1065,2896
02ATGC,Stonebridge                     ,4501,2960,53,557,1541
02ATGD,Sudbury                         ,6214,3926,32,380,2288
02ATGE,Sudbury Court                   ,5541,3833,45,306,1708
02ATGF,Tokyngton                       ,8359,5577,60,639,2782
02ATGG,Wembley Central                 ,6095,4036,53,642,2059
02ATGH,Willesdon Green                 ,6055,3940,55,632,2115
02ATSS,Shipping                        ,0,0,0,0,0
02AUFA,Anerley                         ,9068,6248,58,692,2820
02AUFB,Bickley                         ,10986,6602,29,403,4384
02AUFC,Biggin Hill                     ,8755,6461,29,290,2294
02AUFD,Bromley Common and Keston       ,12886,7818,44,593,5068
02AUFE,Chelsfield and Goddington       ,12169,7682,32,414,4487
02AUFF,Chislehurst                     ,13162,7869,43,455,5293
02AUFG,Clock House                     ,8401,5758,25,416,2643
02AUFH,Copers Cope                     ,6534,4329,19,307,2205
02AUFJ,Crofton                         ,8465,5219,23,218,3246
02AUFK,Darwin                          ,3519,2238,3,139,1281
02AUFL,Eden Park                       ,7459,4707,33,258,2752
02AUFM,Farnborough                     ,7632,4665,28,246,2967
02AUFN,Hayes                           ,11651,7028,38,404,4623
02AUFP,Kelsey Park                     ,7240,4176,13,222,3064
02AUFQ,Lawrie Park and Kent House      ,7579,4972,29,458,2607
02AUFR,Martins Hill and Town           ,7686,5125,19,371,2561
02AUFS,Mottingham                      ,7663,4225,37,436,3438
02AUFT,Orpington Central               ,7379,4560,37,464,2819
02AUFU,Penge                           ,7967,5479,38,705,2488
02AUFW,Petts Wood and Knoll            ,12416,7700,28,392,4716
02AUFX,Plaistow and Sundridge          ,11973,7396,49,523,4577
02AUFY,St. Mary Cray                   ,11540,7253,58,622,4287
02AUFZ,St. Paul's Cray                 ,12403,7188,43,788,5215
02AUGA,Shortlands                      ,8094,4853,28,244,3241
02AUGB,West Wickham North              ,7398,4537,14,221,2861
02AUGC,West Wickham South              ,7999,4811,15,210,3188
02AUSS,Shipping                        ,0,0,0,0,0
02AWFA,Addiscombe                      ,11173,7693,48,600,3480
02AWFB,Ashburton                       ,7040,4406,35,357,2634
02AWFC,Bensham Manor                   ,10860,7354,82,828,3506
02AWFD,Beulah                          ,6956,4611,40,451,2345
02AWFE,Broad Green                     ,9750,6425,65,806,3325
02AWFF,Coulsdon East                   ,9977,6359,35,340,3618
02AWFG,Croham                          ,10774,7418,36,449,3356
02AWFH,Fairfield                       ,13065,8567,71,666,4498
02AWFJ,Fieldway                        ,6613,4271,44,720,2342
02AWFK,Heathfield                      ,9674,6698,33,359,2976
02AWFL,Kenley                          ,7158,4698,24,264,2460
02AWFM,Monks Orchard                   ,8416,5413,29,324,3003
02AWFN,New Addington                   ,8985,5575,30,632,3410
02AWFP,Norbury                         ,10253,6396,46,636,3857
02AWFQ,Purley                          ,11751,7725,50,424,4026
02AWFR,Rylands                         ,6330,4338,36,373,1992
02AWFS,Sanderstead                     ,7787,4747,16,218,3040
02AWFT,Selsdon                         ,7878,5340,29,204,2538
02AWFU,South Norwood                   ,10194,7379,61,676,2815
02AWFW,Spring Park                     ,7977,4833,45,348,3144
02AWFX,Thornton Heath                  ,10547,7312,79,776,3235
02AWFY,Upper Norwood                   ,6792,4465,50,424,2327
02AWFZ,Waddon                          ,10902,7008,47,634,3894
02AWGA,West Thornton                   ,10774,7412,87,821,3362
02AWGB,Whitehorse Manor                ,10512,7187,81,806,3325
02AWGC,Woodcote and Coulsdon West      ,11500,7390,35,359,4110
02AWGD,Woodside                        ,7051,5219,36,420,1832
02AWSS,Shipping                        ,0,0,0,0,0
02AXFA,Argyle                          ,10383,6514,58,656,3869
02AXFB,Costons                         ,8423,5454,52,523,2969
02AXFC,Dormers Wells                   ,9368,5518,74,789,3850
02AXFD,Ealing Common                   ,10691,7140,59,768,3551
02AXFE,Elthorne                        ,9904,6542,41,715,3362
02AXFF,Glebe                           ,9215,6055,97,977,3160
02AXFG,Hanger Lane                     ,9897,6114,50,507,3783
02AXFH,Heathfield                      ,10167,6435,92,1034,3732
02AXFJ,Hobbayne                        ,8624,5700,43,634,2924
02AXFK,Mandeville                      ,8475,5197,26,473,3278
02AXFL,Mount Pleasant                  ,9440,6099,77,911,3341
02AXFM,Northcote                       ,8189,5333,71,1005,2856
02AXFN,Northfield                      ,10191,6988,46,512,3203
02AXFP,Perivale                        ,9810,6584,56,621,3226
02AXFQ,Pitshanger                      ,10384,6676,33,456,3708
02AXFR,Ravenor                         ,9104,5750,44,586,3354
02AXFS,Southfield                      ,8776,6104,35,529,2672
02AXFT,Springfield                     ,9848,6589,62,766,3259
02AXFU,Vale                            ,5884,3799,46,439,2085
02AXFW,Victoria                        ,6075,3968,41,446,2107
02AXFX,Walpole                         ,10443,7165,61,605,3278
02AXFY,Waxlow                          ,9129,6235,60,726,2894
02AXFZ,West End                        ,9203,5892,41,650,3311
02AXGA,Wood End                        ,8569,5953,62,489,2616
02AXSS,Shipping                        ,0,0,0,0,0
02AYFA,Angel Road                      ,5252,3158,58,474,2094
02AYFB,Arnos                           ,6070,3956,64,456,2114
02AYFC,Bowes                           ,6171,4038,56,609,2133
02AYFD,Bullsmoor                       ,6283,3982,27,379,2301
02AYFE,Chase                           ,6176,3836,32,270,2340
02AYFF,Craig Park                      ,5751,3681,72,695,2070
02AYFG,Enfield Lock                    ,7373,5117,32,529,2256
02AYFH,Enfield Wash                    ,6135,4025,39,452,2110
02AYFJ,Grange                          ,6852,4191,23,222,2661
02AYFK,Green Street                    ,6232,4092,44,408,2140
02AYFL,Grovelands                      ,5995,3782,25,242,2213
02AYFM,Highfield                       ,6123,3817,33,397,2306
02AYFN,Hoe Lane                        ,6772,4316,43,509,2456
02AYFP,Huxley                          ,6371,4209,43,525,2162
02AYFQ,Jubilee                         ,6136,4066,45,461,2070
02AYFR,Latymer                         ,5895,3603,50,633,2292
02AYFS,Merryhills                      ,5619,3361,19,216,2258
02AYFT,Oakwood                         ,5677,3007,20,324,2670
02AYFU,Palmers Green                   ,6888,4541,40,468,2347
02AYFW,Ponders End                     ,6239,4166,37,588,2073
02AYFX,Raglan                          ,6875,4443,35,333,2432
02AYFY,St.Alphege                      ,6484,4239,53,501,2245
02AYFZ,St. Marks                       ,5456,3622,37,358,1834
02AYGA,St. Peters                      ,6264,3906,54,532,2358
02AYGB,Southbury                       ,6832,4502,46,374,2330
02AYGC,Southgate Green                 ,6278,3915,23,294,2363
02AYGD,Town                            ,6004,3832,17,280,2172
02AYGE,Trent                           ,6645,3774,21,184,2871
02AYGF,Village                         ,6497,3720,30,226,2777
02AYGG,Weir Hall                       ,5869,3622,47,517,2247
02AYGH,Willow                          ,6344,3925,30,216,2419
02AYGJ,Winchmore Hill                  ,6136,3895,28,216,2241
02AYGK,Worcesters                      ,6234,3956,25,308,2278
02AYSS,Shipping                        ,0,0,0,0,0
02AZFA,Abbey Wood                      ,5501,3430,29,354,2071
02AZFB,Arsenal                         ,2857,1632,45,321,1225
02AZFC,Avery Hill                      ,2644,1367,8,134,1277
02AZFD,Blackheath                      ,5342,3315,19,234,2027
02AZFE,Burrage                         ,2826,1839,37,341,987
02AZFF,Charlton                        ,5051,3410,57,509,1641
02AZFG,Coldharbour                     ,4761,2475,30,264,2286
02AZFH,Deansfield                      ,2695,1776,14,96,919
02AZFJ,Eltham Park                     ,5407,3273,20,197,2134
02AZFK,Eynsham                         ,4875,2633,32,490,2242
02AZFL,Ferrier                         ,4728,2758,42,559,1970
02AZFM,Glyndon                         ,5784,3708,54,636,2076
02AZFN,Herbert                         ,5395,3405,57,574,1990
02AZFP,Hornfair                        ,4975,2737,36,351,2238
02AZFQ,Kidbrooke                       ,4926,2564,26,307,2362
02AZFR,Lakedale                        ,4925,3326,49,472,1599
02AZFS,Middle Park                     ,5361,3073,36,450,2288
02AZFT,New Eltham                      ,5547,3660,15,272,1887
02AZFU,Nightingale                     ,2878,1685,47,352,1193
02AZFW,Palace                          ,2447,1335,9,93,1112
02AZFX,Plumstead Common                ,2877,1788,12,208,1089
02AZFY,Rectory Field                   ,4873,2908,49,452,1965
02AZFZ,St. Alfege                      ,4982,3271,22,472,1711
02AZGA,St. Mary's                      ,4762,2559,62,610,2203
02AZGB,St. Nicholas                    ,5314,3475,36,495,1839
02AZGC,Sherard                         ,5643,3310,36,527,2333
02AZGD,Shrewsbury                      ,2535,1706,24,163,829
02AZGE,Slade                           ,5291,3324,25,318,1967
02AZGF,Sutcliffe                       ,2955,1737,15,153,1218
02AZGG,Tarn                            ,2503,1607,11,154,896
02AZGH,Thamesmead Moorings             ,5287,3625,50,594,1662
02AZGJ,Trafalgar                       ,5209,3188,26,421,2021
02AZGK,Vanbrugh                        ,4974,3136,20,276,1838
02AZGL,Well Hall                       ,5174,3163,21,252,2011
02AZGM,West                            ,4691,2892,27,556,1799
02AZGN,Woolwich Common                 ,5658,3753,61,517,1905
02AZSS,Shipping                        ,0,0,0,0,0
02BAFA,Canons                          ,7388,3984,23,291,3404
02BAFB,Centenary                       ,7046,4555,48,358,2491
02BAFC,Greenhill                       ,6590,4271,37,383,2319
02BAFD,Harrow on the Hill              ,7899,5231,42,355,2668
02BAFE,Harrow Weald                    ,7889,4750,29,343,3139
02BAFF,Hatch End                       ,7380,4439,17,236,2941
02BAFG,Headstone North                 ,8133,5337,28,284,2796
02BAFH,Headstone South                 ,7283,5079,51,401,2204
02BAFJ,Kenton East                     ,7992,5116,47,482,2876
02BAFK,Kenton West                     ,8223,5389,44,386,2834
02BAFL,Marlborough                     ,7247,5023,32,449,2224
02BAFM,Pinner                          ,7782,4532,31,285,3250
02BAFN,Pinner West                     ,7504,4505,25,232,2999
02BAFP,Rayners Lane                    ,7306,4631,38,304,2675
02BAFQ,Ridgeway                        ,7457,4894,39,369,2563
02BAFR,Roxbourne                       ,7913,5166,36,413,2747
02BAFS,Roxeth                          ,7906,5302,39,440,2604
02BAFT,Stanmore Park                   ,8355,4913,45,311,3442
02BAFU,Stanmore South                  ,7724,4928,56,484,2796
02BAFW,Wealdstone                      ,7393,5056,42,478,2337
02BAFX,Wemborough                      ,7705,4958,33,307,2747
02BASS,Shipping                        ,0,0,0,0,0
02BBFA,Airfield                        ,7885,4956,32,413,2929
02BBFB,Ardleigh Green                  ,6459,4198,19,211,2261
02BBFC,Brooklands                      ,5914,3746,25,310,2168
02BBFD,Chase Cross                     ,5778,3552,32,422,2226
02BBFE,Collier Row                     ,5839,3931,32,307,1908
02BBFF,Cranham East                    ,5790,3443,24,217,2347
02BBFG,Cranham West                    ,5795,3511,16,173,2284
02BBFH,Elm Park                        ,9194,5961,45,391,3233
02BBFJ,Emerson Park                    ,7360,4782,31,241,2578
02BBFK,Gidea Park                      ,5900,3567,15,182,2333
02BBFL,Gooshays                        ,8221,4360,33,560,3861
02BBFM,Hacton                          ,8649,5179,26,325,3470
02BBFN,Harold Wood                     ,8197,5379,31,300,2818
02BBFP,Heath Park                      ,6841,4362,30,294,2479
02BBFQ,Heaton                          ,8929,5177,59,606,3752
02BBFR,Hilldene                        ,6611,3401,40,452,3210
02BBFS,Hylands                         ,9171,6081,37,379,3090
02BBFT,Mawney                          ,8865,5407,31,385,3458
02BBFU,Oldchurch                       ,5520,3678,33,336,1842
02BBFW,Rainham                         ,9568,6450,45,449,3118
02BBFX,Rise Park                       ,6037,3837,21,220,2200
02BBFY,St.Andrew's                     ,9096,5664,28,355,3432
02BBFZ,St.Edward's                     ,5193,3211,27,202,1982
02BBGA,South Hornchurch                ,8868,5855,27,547,3013
02BBGB,Upminster                       ,8783,5364,29,221,3419
02BBSS,Shipping                        ,0,0,0,0,0
02BCFA,Barnhill                        ,7351,4846,38,420,2505
02BCFB,Botwell                         ,5275,3422,28,329,1853
02BCFC,Bourne                          ,5735,3818,32,235,1917
02BCFD,Cavendish                       ,5259,3177,27,183,2082
02BCFE,Charville                       ,7771,5487,33,337,2284
02BCFF,Colham                          ,5142,3581,24,276,1561
02BCFG,Cowley                          ,6979,4591,19,322,2388
02BCFH,Crane                           ,5270,3630,33,302,1640
02BCFJ,Deansfield                      ,5826,3913,17,207,1913
02BCFK,Eastcote                        ,8288,5081,26,272,3207
02BCFL,Harefield                       ,5282,3445,18,261,1837
02BCFM,Harlington                      ,7959,5734,40,354,2225
02BCFN,Heathrow                        ,5992,4072,32,307,1920
02BCFP,Hillingdon East                 ,5455,3583,26,279,1872
02BCFQ,Hillingdon North                ,5477,3690,27,227,1787
02BCFR,Hillingdon West                 ,7669,5307,58,282,2362
02BCFS,Ickenham                        ,9518,6081,39,288,3437
02BCFT,Manor                           ,5763,3989,15,165,1774
02BCFU,Northwood                       ,7841,4575,27,221,3266
02BCFW,Northwood Hills                 ,7876,4728,21,314,3148
02BCFX,Ruislip                         ,5875,3823,14,185,2052
02BCFY,St.Martins                      ,6301,3802,24,186,2499
02BCFZ,Townfield                       ,8633,5619,49,579,3014
02BCGA,Uxbridge North                  ,5329,3540,24,188,1789
02BCGB,Uxbridge South                  ,4391,2955,26,281,1436
02BCGC,West Drayton                    ,5622,3894,14,270,1728
02BCGD,Wood End                        ,5347,3562,28,334,1785
02BCGE,Yeading                         ,6862,4859,41,462,2003
02BCGF,Yiewsley                        ,5745,3931,30,344,1814
02BCSS,Shipping                        ,0,0,0,0,0
02BDFA,Brentford Clifden               ,6743,4606,23,424,2137
02BDFB,Chiswick Homefields             ,5850,4040,31,304,1810
02BDFC,Chiswick Riverside              ,7597,4892,22,394,2705
02BDFD,Cranford                        ,7510,4902,57,577,2608
02BDFE,East Bedfont                    ,9380,6189,35,479,3191
02BDFF,Feltham Central                 ,8043,5412,42,411,2631
02BDFG,Feltham North                   ,8608,5815,43,462,2793
02BDFH,Feltham South                   ,6934,4691,38,326,2243
02BDFJ,Gunnersbury                     ,8421,5462,34,610,2959
02BDFK,Hanworth                        ,7814,5007,49,470,2807
02BDFL,Heston Central                  ,5227,3473,35,308,1754
02BDFM,Heston East                     ,5305,3505,34,315,1800
02BDFN,Heston West                     ,8630,5457,65,693,3173
02BDFP,Hounslow Central                ,7493,4970,73,450,2523
02BDFQ,Hounslow Heath                  ,8807,5761,69,637,3046
02BDFR,Hounslow South                  ,8255,5737,43,364,2518
02BDFS,Hounslow West                   ,9799,6583,64,688,3216
02BDFT,Isleworth North                 ,8280,5381,51,357,2899
02BDFU,Isleworth South                 ,7969,5235,52,518,2734
02BDFW,Spring Grove                    ,8953,5902,39,386,3051
02BDFX,Turnham Green                   ,7194,4749,27,412,2445
02BDSS,Shipping                        ,0,0,0,0,0
02BEFA,Berrylands                      ,6944,4475,24,224,2469
02BEFB,Burlington                      ,4543,2906,21,179,1637
02BEFC,Cambridge                       ,6316,3942,23,253,2374
02BEFD,Canbury                         ,6207,4135,38,280,2072
02BEFE,Chessington North               ,4088,2687,8,116,1401
02BEFF,Chessington South               ,7141,4982,28,224,2159
02BEFG,Coombe                          ,4131,2388,20,164,1743
02BEFH,Grove                           ,6826,4423,28,355,2403
02BEFJ,Hill                            ,4722,3028,18,184,1694
02BEFK,Hook                            ,4093,2753,10,121,1340
02BEFL,Malden Manor                    ,3940,2522,11,120,1418
02BEFM,Norbiton                        ,6297,4011,40,395,2286
02BEFN,Norbiton Park                   ,4680,2715,14,155,1965
02BEFP,St.James                        ,5801,3570,20,188,2231
02BEFQ,St.Mark's                       ,6943,4908,36,340,2035
02BEFR,Surbiton Hill                   ,6459,3870,16,246,2589
02BEFS,Tolworth East                   ,4205,2903,18,143,1302
02BEFT,Tolworth South                  ,4307,2922,9,182,1385
02BEFU,Tolworth West                   ,4494,3001,12,165,1493
02BEFW,Tudor                           ,6631,4164,10,205,2467
02BESS,Shipping                        ,0,0,0,0,0
02BFFA,Abbey                           ,7544,5090,31,486,2454
02BFFB,Cannon Hill                     ,7061,4412,22,297,2649
02BFFC,Colliers Wood                   ,8272,6142,47,698,2130
02BFFD,Dundonald                       ,6644,4647,29,323,1997
02BFFE,Durnsford                       ,4596,3079,24,208,1517
02BFFF,Figge's Marsh                   ,7834,5274,57,619,2560
02BFFG,Graveney                        ,4525,3201,39,385,1324
02BFFH,Hillside                        ,7767,4904,26,346,2863
02BFFJ,Lavender                        ,4462,2750,36,422,1712
02BFFK,Longthornton                    ,7619,5069,42,475,2550
02BFFL,Lower Morden                    ,6959,4440,18,245,2519
02BFFM,Merton Park                     ,7052,4604,29,265,2448
02BFFN,Phipps Bridge                   ,8196,5135,43,624,3061
02BFFP,Pollards Hill                   ,6561,4247,38,487,2314
02BFFQ,Ravensbury                      ,6871,3911,26,395,2960
02BFFR,Raynes Park                     ,7900,4680,32,325,3220
02BFFS,St.Helier                       ,6762,3758,29,400,3004
02BFFT,Trinity                         ,6373,4412,31,358,1961
02BFFU,Village                         ,6961,3958,25,221,3003
02BFFW,West Barnes                     ,7409,4756,26,286,2653
02BFSS,Shipping                        ,0,0,0,0,0
02BGFA,Aldborough                      ,8848,5332,59,456,3516
02BGFB,Barkingside                     ,10044,6283,56,427,3761
02BGFC,Bridge                          ,9161,5818,58,562,3343
02BGFD,Chadwell                        ,9490,6167,31,397,3323
02BGFE,Church End                      ,7277,4679,20,308,2598
02BGFF,Clayhall                        ,10015,6088,64,379,3927
02BGFG,Clementswood                    ,8744,5562,94,671,3182
02BGFH,Cranbrook                       ,8180,5113,63,431,3067
02BGFJ,Fairlop                         ,9012,5391,55,383,3621
02BGFK,Fullwell                        ,8912,5191,34,433,3721
02BGFL,Goodmayes                       ,8804,5493,58,686,3311
02BGFM,Hainault                        ,7379,3854,37,406,3525
02BGFN,Loxford                         ,9152,5524,93,831,3628
02BGFP,Mayfield                        ,9209,5682,43,479,3527
02BGFQ,Monkhams                        ,8055,4907,28,259,3148
02BGFR,Newbury                         ,8613,5689,54,515,2924
02BGFS,Roding                          ,8606,5649,44,381,2957
02BGFT,Seven Kings                     ,8474,5281,59,556,3193
02BGFU,Snaresbrook                     ,7957,4551,30,343,3406
02BGFW,Valentines                      ,7962,5331,51,640,2631
02BGFX,Wanstead                        ,7506,4727,25,354,2779
02BGSS,Shipping                        ,0,0,0,0,0
02BHFA,Barnes                          ,7748,4743,23,394,3005
02BHFB,Central Twickenham              ,6193,4247,26,264,1946
02BHFC,East Sheen                      ,5208,3177,12,181,2031
02BHFD,East Twickenham                 ,7898,5413,18,367,2485
02BHFE,Ham and Petersham               ,6913,4114,21,327,2799
02BHFF,Hampton                         ,7178,4532,21,252,2646
02BHFG,Hampton Hill                    ,7283,4839,16,253,2444
02BHFH,Hampton Nursery                 ,5313,3535,27,224,1778
02BHFJ,Hampton Wick                    ,8107,5060,34,318,3047
02BHFK,Heathfield                      ,7749,4884,22,319,2865
02BHFL,Kew                             ,8372,5324,30,356,3048
02BHFM,Mortlake                        ,6627,4320,25,338,2307
02BHFN,Palewell                        ,7017,4364,24,249,2653
02BHFP,Richmond Hill                   ,7703,4840,25,307,2863
02BHFQ,Richmond Town                   ,5515,3521,20,262,1994
02BHFR,South Twickenham                ,7524,4788,26,337,2736
02BHFS,Teddington                      ,8164,5432,24,308,2732
02BHFT,West Twickenham                 ,5228,3628,21,229,1600
02BHFU,Whitton                         ,7511,4868,31,291,2643
02BHSS,Shipping                        ,0,0,0,0,0
02BJFA,Beddington North                ,5166,3600,6,233,1566
02BJFB,Beddington South                ,7224,4565,28,481,2659
02BJFC,Belmont                         ,5926,3945,23,188,1981
02BJFD,Carshalton Beeches              ,7261,4589,15,230,2672
02BJFE,Carshalton Central              ,5071,3294,10,199,1777
02BJFF,Carshalton North                ,5495,3892,14,240,1603
02BJFG,Cheam South                     ,4765,2736,16,109,2029
02BJFH,Cheam West                      ,4632,2917,13,158,1715
02BJFJ,Clockhouse                      ,1660,992,4,73,668
02BJFK,North Cheam                     ,5113,3487,17,150,1626
02BJFL,Rosehill                        ,4739,3018,17,176,1721
02BJFM,St.Helier North                 ,6642,3568,30,430,3074
02BJFN,St.Helier South                 ,4184,2383,17,296,1801
02BJFP,Sutton Central                  ,5416,3538,21,263,1878
02BJFQ,Sutton Common                   ,4747,3104,9,174,1643
02BJFR,Sutton East                     ,6320,4372,25,353,1948
02BJFS,Sutton South                    ,8188,5049,28,293,3139
02BJFT,Sutton West                     ,4669,3244,17,166,1425
02BJFU,Wallington North                ,7602,5214,35,313,2388
02BJFW,Wallington South                ,7631,4788,20,326,2843
02BJFX,Wandle Valley                   ,4126,2765,16,230,1361
02BJFY,Woodcote                        ,2839,1801,4,109,1038
02BJFZ,Worcester Park North            ,6889,4660,19,270,2229
02BJGA,Worcester Park South            ,4648,2966,10,149,1682
02BJGB,Wrythe Green                    ,5432,3650,23,246,1782
02BJSS,Shipping                        ,0,0,0,0,0
02BKFA,Cann Hall                       ,7989,5006,63,715,2983
02BKFB,Cathall                         ,8630,5389,113,1021,3241
02BKFC,Chapel End                      ,8347,5508,42,545,2839
02BKFD,Chingford Green                 ,9162,5412,22,422,3750
02BKFE,Endlebury                       ,6373,4121,29,314,2252
02BKFF,Forest                          ,8723,5712,81,773,3011
02BKFG,Grove Green                     ,8670,5707,58,713,2963
02BKFH,Hale End                        ,5663,3633,30,256,2030
02BKFJ,Hatch Lane                      ,8727,4752,40,394,3975
02BKFK,Higham Hill                     ,5171,3091,39,500,2080
02BKFL,High Street                     ,8652,5570,69,700,3082
02BKFM,Hoe Street                      ,9650,6002,96,864,3648
02BKFN,Larkswood                       ,10129,6442,41,536,3687
02BKFP,Lea Bridge                      ,8385,5411,73,709,2974
02BKFQ,Leyton                          ,8743,5533,84,984,3210
02BKFR,Leytonstone                     ,8982,5974,76,827,3008
02BKFS,Lloyd Park                      ,8607,5743,56,831,2864
02BKFT,St.James Street                 ,10341,6799,77,1044,3542
02BKFU,Valley                          ,8760,5618,50,563,3142
02BKFW,Wood Street                     ,9200,5586,56,724,3614
02BKSS,Shipping                        ,0,0,0,0,0
03BLFA,Astley Bridge                   ,11019,6898,55,500,4121
03BLFB,Blackrod                        ,9998,6427,66,415,3571
03BLFC,Bradshaw                        ,10897,7085,55,443,3812
03BLFD,Breightmet                      ,11214,6897,101,942,4317
03BLFE,Bromley Cross                   ,10620,6901,64,411,3719
03BLFF,Burnden                         ,9862,5784,75,867,4078
03BLFG,Central                         ,8369,4147,82,1078,4222
03BLFH,Daubhill                        ,8893,5338,49,558,3555
03BLFJ,Deane-Cum-Heaton                ,13499,7706,84,600,5793
03BLFK,Derby                           ,9529,4705,92,1118,4824
03BLFL,Farnworth                       ,9457,5374,79,781,4083
03BLFM,Halliwell                       ,9911,5849,59,814,4062
03BLFN,Harper Green                    ,10587,6174,81,776,4413
03BLFP,Horwich                         ,11552,7036,81,582,4516
03BLFQ,Hulton Park                     ,11939,7755,75,402,4184
03BLFR,Kearsley                        ,10120,6425,54,562,3695
03BLFS,Little Lever                    ,9508,6511,82,422,2997
03BLFT,Smithills                       ,8896,5287,45,368,3609
03BLFU,Tonge                           ,8803,5085,56,582,3718
03BLFW,Westhoughton                    ,8101,5529,48,436,2572
03BLSS,Shipping                        ,0,0,0,0,0
03BMFA,Besses                          ,7292,4403,47,464,2889
03BMFB,Church                          ,8684,5566,42,274,3118
03BMFC,East                            ,8155,4740,43,562,3415
03BMFD,Elton                           ,9581,6579,50,408,3002
03BMFE,Holyrood                        ,8517,5416,34,391,3101
03BMFF,Moorside                        ,8552,5283,75,494,3269
03BMFG,Pilkington Park                 ,8113,4969,43,292,3144
03BMFH,Radcliffe Central               ,8238,5501,42,449,2737
03BMFJ,Radcliffe North                 ,10125,6558,58,408,3567
03BMFK,Radcliffe South                 ,7789,4751,44,466,3038
03BMFL,Ramsbottom                      ,10912,7381,46,372,3531
03BMFM,Redvales                        ,8386,4872,71,590,3514
03BMFN,St.Mary's                       ,9836,5794,45,461,4042
03BMFP,Sedgley                         ,8102,5043,49,387,3059
03BMFQ,Tottington                      ,9944,6542,51,276,3402
03BMFR,Unsworth                        ,7712,5207,34,234,2505
03BMSS,Shipping                        ,0,0,0,0,0
03BNFA,Ardwick                         ,7527,3657,109,1113,3870
03BNFB,Baguley                         ,9341,5175,81,758,4166
03BNFC,Barlow Moor                     ,10265,6037,102,1002,4228
03BNFD,Benchill                        ,8729,4501,89,1180,4228
03BNFE,Beswick and Clayton             ,8809,4477,74,1081,4332
03BNFF,Blackley                        ,9358,4824,60,843,4534
03BNFG,Bradford                        ,8608,4692,89,1086,3916
03BNFH,Brooklands                      ,9892,5219,52,709,4673
03BNFJ,Burnage                         ,10545,5620,90,868,4925
03BNFK,Central                         ,6865,3413,82,1159,3452
03BNFL,Charlestown                     ,9891,5210,76,975,4681
03BNFM,Cheetham                        ,10179,5091,121,1667,5088
03BNFN,Chorlton                        ,11301,7289,92,865,4012
03BNFP,Crumpsall                       ,9678,5596,81,763,4082
03BNFQ,Didsbury                        ,10976,6709,64,497,4267
03BNFR,Fallowfield                     ,8445,4457,85,899,3988
03BNFS,Gorton North                    ,11009,6416,87,845,4593
03BNFT,Gorton South                    ,10034,5515,115,1113,4519
03BNFU,Harpurhey                       ,8834,4449,83,1118,4385
03BNFW,Hulme                           ,6273,3314,141,1285,2959
03BNFX,Levenshulme                     ,10206,6214,107,895,3992
03BNFY,Lightbowne                      ,9897,5593,63,852,4304
03BNFZ,Longsight                       ,10818,5567,147,1512,5251
03BNGA,Moss Side                       ,9579,5166,125,1452,4413
03BNGB,Moston                          ,10029,5867,78,692,4162
03BNGC,Newton Heath                    ,9722,5097,76,948,4625
03BNGD,Northenden                      ,10020,5375,61,705,4645
03BNGE,Old Moat                        ,10632,6103,83,937,4529
03BNGF,Rusholme                        ,8061,4296,78,908,3765
03BNGG,Sharston                        ,9145,5014,57,738,4131
03BNGH,Whalley Range                   ,9861,5904,121,1169,3957
03BNGJ,Withington                      ,9857,5791,72,730,4066
03BNGK,Woodhouse Park                  ,8835,4633,58,883,4202
03BNSS,Shipping                        ,0,0,0,0,0
03BPFA,Alexandra                       ,8157,4470,88,944,3687
03BPFB,Chadderton Central              ,8976,6111,95,394,2865
03BPFC,Chadderton North                ,8253,5148,63,357,3105
03BPFD,Chadderton South                ,8328,5164,64,463,3164
03BPFE,Coldhurst                       ,8106,4141,90,873,3965
03BPFF,Crompton                        ,8747,5868,47,360,2879
03BPFG,Failsworth East                 ,8597,5626,49,454,2971
03BPFH,Failsworth West                 ,8423,5304,60,532,3119
03BPFJ,Hollinwood                      ,7337,4176,78,775,3161
03BPFK,Lees                            ,7831,4734,70,711,3097
03BPFL,Royton North                    ,8836,5917,50,362,2919
03BPFM,Royton South                    ,7935,5255,65,331,2680
03BPFN,Saddleworth East                ,10207,6648,45,275,3559
03BPFP,Saddleworth West                ,8761,5901,66,314,2860
03BPFQ,St.James                        ,6398,3906,88,659,2492
03BPFR,St.Marys                        ,8587,4871,103,908,3716
03BPFS,St.Pauls                        ,8318,4899,59,531,3419
03BPFT,Shaw                            ,8177,5387,54,412,2790
03BPFU,Waterhead                       ,9947,6514,71,658,3433
03BPFW,Werneth                         ,8022,4329,88,894,3693
03BPSS,Shipping                        ,0,0,0,0,0
03BQFA,Balderstone                     ,7459,4179,74,720,3280
03BQFB,Brimrod and Deeplish            ,6675,3749,67,526,2926
03BQFC,Castleton                       ,7799,5097,66,388,2702
03BQFD,Central and Falinge             ,8215,4452,129,931,3763
03BQFE,Healey                          ,9108,6129,78,447,2979
03BQFF,Heywood North                   ,7324,4444,30,563,2880
03BQFG,Heywood South                   ,8790,5645,61,589,3145
03BQFH,Heywood West                    ,7372,4799,76,838,2573
03BQFJ,Littleborough                   ,9331,6087,71,420,3244
03BQFK,Middleton Central               ,6796,3780,84,702,3016
03BQFL,Middleton East                  ,6599,4161,51,395,2438
03BQFM,Middleton North                 ,8939,5842,68,559,3097
03BQFN,Middleton South                 ,8038,4843,41,368,3195
03BQFP,Middleton West                  ,5248,2752,51,634,2496
03BQFQ,Milnrow                         ,8886,5929,65,366,2957
03BQFR,Newbold                         ,7711,4364,94,761,3347
03BQFS,Norden and Bamford              ,9615,6500,37,263,3115
03BQFT,Smallbridge and Wardleworth     ,9004,4815,138,927,4189
03BQFU,Spotland                        ,6255,3611,39,377,2644
03BQFW,Wardle                          ,6699,4363,48,332,2336
03BQSS,Shipping                        ,0,0,0,0,0
03BRFA,Barton                          ,8101,4473,46,574,3628
03BRFB,Blackfriars                     ,6098,2903,49,822,3195
03BRFC,Broughton                       ,7724,4111,56,919,3613
03BRFD,Cadishead                       ,7077,4315,56,451,2762
03BRFE,Claremont                       ,10676,6494,40,649,4182
03BRFF,Eccles                          ,9646,5461,66,604,4185
03BRFG,Irlam                           ,7705,4916,55,550,2789
03BRFH,Kersal                          ,8630,4509,65,590,4121
03BRFJ,Langworthy                      ,8111,4845,60,999,3266
03BRFK,Little Hulton                   ,8806,4370,60,888,4436
03BRFL,Ordsall                         ,5538,3237,45,727,2301
03BRFM,Pendlebury                      ,11107,6471,71,708,4636
03BRFN,Pendleton                       ,8019,3970,55,1014,4049
03BRFP,Swinton North                   ,9997,6080,60,549,3917
03BRFQ,Swinton South                   ,10459,6480,59,477,3979
03BRFR,Walkden North                   ,9048,4880,76,650,4168
03BRFS,Walkden South                   ,10718,6572,64,530,4146
03BRFT,Weaste and Seedley              ,8274,4390,52,566,3884
03BRFU,Winton                          ,9728,5471,62,851,4257
03BRFW,Worsley and Boothstown          ,9469,6153,38,275,3316
03BRSS,Shipping                        ,0,0,0,0,0
03BSFA,Bredbury                        ,11858,7707,61,502,4151
03BSFB,Brinnington                     ,8240,4531,78,903,3709
03BSFC,Cale Green                      ,8998,5559,70,571,3439
03BSFD,Cheadle                         ,9971,5880,35,310,4091
03BSFE,Cheadle Hulme North             ,11954,7453,48,414,4501
03BSFF,Cheadle Hulme South             ,11415,7584,52,334,3831
03BSFG,Davenport                       ,9715,5998,55,488,3717
03BSFH,East Bramhall                   ,13166,8748,50,288,4418
03BSFJ,Edgeley                         ,10074,6634,61,632,3440
03BSFK,Great Moor                      ,11104,6583,73,489,4521
03BSFL,Hazel Grove                     ,12515,8455,51,390,4060
03BSFM,Heald Green                     ,10559,6753,48,359,3806
03BSFN,Heaton Mersey                   ,12088,8016,37,499,4072
03BSFP,Heaton Moor                     ,10069,6380,50,395,3689
03BSFQ,Manor                           ,9602,6437,65,412,3165
03BSFR,North Marple                    ,9656,5889,52,304,3767
03BSFS,North Reddish                   ,12353,8142,80,748,4211
03BSFT,Romiley                         ,11488,6832,71,470,4656
03BSFU,South Marple                    ,10071,6124,46,294,3947
03BSFW,South Reddish                   ,11016,6710,54,736,4306
03BSFX,West Bramhall                   ,11867,7172,42,349,4695
03BSSS,Shipping                        ,0,0,0,0,0
03BTFA,Ashton Hurst                    ,9920,6462,102,621,3458
03BTFB,Ashton St.Michael's             ,8708,5188,83,577,3520
03BTFC,Ashton St.Peters'               ,8314,4886,102,758,3428
03BTFD,Ashton Waterloo                 ,8053,4657,69,437,3396
03BTFE,Audenshaw                       ,10434,6837,81,575,3597
03BTFF,Denton North East               ,10180,6755,80,587,3425
03BTFG,Denton South                    ,9188,5343,53,578,3845
03BTFH,Denton West                     ,9612,6053,53,353,3559
03BTFJ,Droylsden East                  ,9522,6023,67,573,3499
03BTFK,Droylsden West                  ,8537,5556,72,530,2981
03BTFL,Dukinfield                      ,9523,5986,70,579,3537
03BTFM,Dukinfield Stalybridge          ,8372,5238,52,443,3134
03BTFN,Hyde Godley                     ,8848,5190,91,815,3658
03BTFP,Hyde Newton                     ,9365,5925,70,632,3440
03BTFQ,Hyde Werneth                    ,9054,5661,51,450,3393
03BTFR,Longdendale                     ,8235,5075,87,595,3160
03BTFS,Mossley                         ,7995,5386,68,379,2609
03BTFT,Stalybridge North               ,8411,5515,61,549,2896
03BTFU,Stalybridge South               ,8532,5507,47,465,3025
03BTSS,Shipping                        ,0,0,0,0,0
03BUFA,Altrincham                      ,8648,5215,36,355,3433
03BUFB,Bowdon                          ,8957,5334,26,271,3623
03BUFC,Broadheath                      ,8881,6133,42,335,2748
03BUFD,Brooklands                      ,8165,5152,24,270,3013
03BUFE,Bucklow                         ,6508,3888,46,677,2620
03BUFF,Clifford                        ,8108,4504,98,991,3604
03BUFG,Davyhulme East                  ,7640,5079,36,290,2561
03BUFH,Davyhulme West                  ,8047,5356,47,331,2691
03BUFJ,Flixton                         ,7883,4890,41,272,2993
03BUFK,Hale                            ,8770,4958,26,227,3812
03BUFL,Longford                        ,7751,4577,47,496,3174
03BUFM,Mersey St.Mary's                ,9674,6130,23,311,3544
03BUFN,Park                            ,6064,3782,30,355,2282
03BUFP,Priory                          ,7890,5039,31,366,2851
03BUFQ,St.Martin's                     ,9145,5362,73,590,3783
03BUFR,Sale Moor                       ,7799,4731,40,419,3068
03BUFS,Stretford                       ,8096,4970,50,420,3126
03BUFT,Talbot                          ,6740,4231,54,616,2509
03BUFU,Timperley                       ,8871,5833,40,288,3038
03BUFW,Urmston                         ,7735,4717,30,380,3018
03BUFX,Village                         ,8324,4956,32,339,3368
03BUSS,Shipping                        ,0,0,0,0,0
03BWFA,Abram                           ,10005,5835,125,845,4170
03BWFB,Ashton-Golborne                 ,10043,6409,82,550,3634
03BWFC,Aspull-Standish                 ,11029,6554,74,481,4475
03BWFD,Atherton                        ,9498,5376,80,702,4122
03BWFE,Bedford-Astley                  ,10212,6388,73,612,3824
03BWFF,Beech Hill                      ,9110,5357,77,662,3753
03BWFG,Bryn                            ,9988,6053,105,532,3935
03BWFH,Hindley                         ,9906,5630,92,642,4276
03BWFJ,Hindley Green                   ,11712,7587,115,706,4125
03BWFK,Hindsford                       ,11122,6699,101,705,4423
03BWFL,Hope Carr                       ,10228,6114,68,524,4114
03BWFM,Ince                            ,8099,4124,76,753,3975
03BWFN,Langtree                        ,11463,7608,96,476,3855
03BWFP,Leigh Central                   ,9521,5633,82,711,3888
03BWFQ,Leigh East                      ,10507,6275,72,557,4232
03BWFR,Lightshaw                       ,11060,6705,59,650,4355
03BWFS,Newtown                         ,9365,5233,110,942,4132
03BWFT,Norley                          ,7799,4002,126,876,3797
03BWFU,Orrell                          ,10255,6040,60,442,4215
03BWFW,Swinley                         ,9040,5310,77,419,3730
03BWFX,Tyldesley East                  ,11917,8335,70,584,3582
03BWFY,Whelley                         ,9012,4940,91,756,4072
03BWFZ,Winstanley                      ,11951,8083,105,582,3868
03BWGA,Worsley Mesnes                  ,10206,6495,127,777,3711
03BWSS,Shipping                        ,0,0,0,0,0
04BXFA,Cantril Farm                    ,4110,2327,108,859,1783
04BXFB,Cherryfield                     ,5064,2451,121,756,2613
04BXFC,Halewood East                   ,5524,3911,63,293,1613
04BXFD,Halewood South                  ,4395,2517,89,686,1878
04BXFE,Halewood West                   ,5197,2865,79,629,2332
04BXFF,Kirkby Central                  ,4816,2361,108,776,2455
04BXFG,Knowsley Park                   ,5315,2836,114,640,2479
04BXFH,Longview                        ,4893,2506,129,986,2387
04BXFJ,Northwood                       ,4463,2272,89,876,2191
04BXFK,Page Moss                       ,6154,3381,112,735,2773
04BXFL,Park                            ,5919,3630,118,748,2289
04BXFM,Prescot East                    ,5019,2844,77,521,2175
04BXFN,Prescot West                    ,4416,2361,43,288,2055
04BXFP,Princess                        ,5209,2456,148,1000,2753
04BXFQ,Roby                            ,6921,4372,67,303,2549
04BXFR,St.Gabriels                     ,5016,2545,80,646,2471
04BXFS,St.Michaels                     ,4504,2384,106,569,2120
04BXFT,Swanside                        ,6221,3864,50,338,2357
04BXFU,Tower Hill                      ,6004,3688,202,1152,2316
04BXFW,Whiston North                   ,5137,3083,68,382,2054
04BXFX,Whiston South                   ,5330,3226,74,486,2104
04BXFY,Whitefield                      ,5452,3177,86,711,2275
04BXSS,Shipping                        ,0,0,0,0,0
04BYFA,Abercromby                      ,7216,3746,187,1237,3470
04BYFB,Aigburth                        ,12567,6857,139,1020,5710
04BYFC,Allerton                        ,12201,6787,127,687,5414
04BYFD,Anfield                         ,11960,6921,211,1279,5039
04BYFE,Arundel                         ,9795,5283,186,1223,4512
04BYFF,Breckfield                      ,10459,5309,217,1692,5150
04BYFG,Broadgreen                      ,12755,6570,138,1117,6185
04BYFH,Childwall                       ,12737,7530,112,664,5207
04BYFJ,Church                          ,14531,8617,132,861,5914
04BYFK,Clubmoor                        ,12251,6088,198,1743,6163
04BYFL,County                          ,12327,6601,197,1400,5726
04BYFM,Croxteth                        ,13756,8058,135,941,5698
04BYFN,Dingle                          ,10597,5891,192,1327,4706
04BYFP,Dovecot                         ,9994,5219,198,1505,4775
04BYFQ,Everton                         ,4793,2326,90,1026,2467
04BYFR,Fazakerley                      ,10462,5884,177,1125,4578
04BYFS,Gillmoss                        ,11508,6378,178,1629,5130
04BYFT,Granby                          ,9617,4809,303,1969,4808
04BYFU,Grassendale                     ,12365,7103,118,544,5262
04BYFW,Kensington                      ,11838,6640,290,1767,5198
04BYFX,Melrose                         ,11622,6352,207,1702,5270
04BYFY,Netherley                       ,6474,3797,127,1052,2677
04BYFZ,Old Swan                        ,11136,6616,157,1176,4520
04BYGA,Picton                          ,10844,6162,162,1283,4682
04BYGB,Pirrie                          ,10720,5571,218,1588,5149
04BYGC,St. Mary's                      ,10384,5544,156,1269,4840
04BYGD,Smithdown                       ,8672,4736,181,1515,3936
04BYGE,Speke                           ,8314,4095,185,1288,4219
04BYGF,Tuebrook                        ,12212,7112,261,1489,5100
04BYGG,Valley                          ,8608,4585,166,1075,4023
04BYGH,Vauxhall                        ,5753,2569,82,1129,3184
04BYGJ,Warbreck                        ,14511,8903,205,1396,5608
04BYGK,Woolton                         ,12836,7109,114,632,5727
04BYSS,Shipping                        ,0,0,0,0,0
04BZFA,Billinge and Seneley Green      ,10408,6857,117,507,3551
04BZFB,Blackbrook                      ,7532,4654,108,496,2878
04BZFC,Broad Oak                       ,7510,4178,178,714,3332
04BZFD,Eccleston                       ,7839,4437,46,269,3402
04BZFE,Grange Park                     ,7571,4238,124,626,3333
04BZFF,Haydock                         ,8833,5081,102,543,3752
04BZFG,Marshalls Cross                 ,6945,4060,139,647,2885
04BZFH,Moss Bank                       ,8554,4692,133,558,3862
04BZFJ,Newton East                     ,7827,4566,73,530,3261
04BZFK,Newton West                     ,7675,4197,75,612,3478
04BZFL,Parr and Hardshaw               ,7005,3593,154,796,3412
04BZFM,Queen's Park                    ,7313,4035,142,547,3278
04BZFN,Rainford                        ,7172,4498,86,257,2674
04BZFP,Rainhill                        ,10097,6419,93,427,3678
04BZFQ,Sutton and Bold                 ,7874,4866,123,459,3008
04BZFR,Thatto Heath                    ,7879,4575,132,614,3304
04BZFS,West Sutton                     ,7137,4182,181,667,2955
04BZFT,Windle                          ,7336,3960,85,391,3376
04BZSS,Shipping                        ,0,0,0,0,0
04CAFA,Ainsdale                        ,10844,6117,113,431,4727
04CAFB,Birkdale                        ,9502,5754,94,369,3748
04CAFC,Blundellsands                   ,9547,5230,79,368,4317
04CAFD,Cambridge                       ,11623,5239,69,440,6384
04CAFE,Church                          ,9615,5557,137,957,4058
04CAFF,Derby                           ,9943,5761,172,1131,4182
04CAFG,Duke's                          ,10694,5025,79,509,5669
04CAFH,Ford                            ,9733,5453,176,1056,4280
04CAFJ,Harington                       ,11039,6564,68,310,4475
04CAFK,Kew                             ,10495,6305,99,562,4190
04CAFL,Linacre                         ,8687,4549,209,1465,4138
04CAFM,Litherland                      ,9344,5322,174,1052,4022
04CAFN,Manor                           ,10426,6011,137,633,4415
04CAFP,Meols                           ,10390,6006,69,331,4384
04CAFQ,Molyneux                        ,11652,6782,99,585,4870
04CAFR,Netherton                       ,7974,4222,135,841,3752
04CAFS,Norwood                         ,10233,6270,112,500,3963
04CAFT,Orrell                          ,9182,5066,175,951,4116
04CAFU,Park                            ,11746,7503,111,537,4243
04CAFW,Ravenmeols                      ,9805,5875,58,352,3930
04CAFX,St.Oswald                       ,7814,4352,127,799,3462
04CAFY,Sudell                          ,11833,7762,94,506,4071
04CAFZ,Victoria                        ,9800,5863,94,525,3937
04CASS,Shipping                        ,0,0,0,0,0
04CBFA,Bebington                       ,11332,6634,124,513,4698
04CBFB,Bidston                         ,8998,4355,172,1434,4643
04CBFC,Birkenhead                      ,11398,6223,185,1698,5175
04CBFD,Bromborough                     ,11725,6673,175,835,5052
04CBFE,Clatterbridge                   ,14472,8855,98,422,5617
04CBFF,Claughton                       ,11271,6736,121,815,4535
04CBFG,Eastham                         ,12076,7511,143,601,4565
04CBFH,Egerton                         ,11541,6538,160,905,5003
04CBFJ,Heswall                         ,13556,7258,55,362,6298
04CBFK,Hoylake                         ,12895,6752,108,479,6143
04CBFL,Leasowe                         ,10036,5356,192,1063,4680
04CBFM,Liscard                         ,11884,6968,121,963,4916
04CBFN,Moreton                         ,9746,5751,101,604,3995
04CBFP,New Brighton                    ,12085,6773,160,923,5312
04CBFQ,Oxton                           ,12196,7574,138,709,4622
04CBFR,Prenton                         ,12330,6849,131,669,5481
04CBFS,Royden                          ,13083,7849,90,457,5234
04CBFT,Seacombe                        ,12003,6855,195,1266,5148
04CBFU,Thurstaston                     ,12918,7274,73,458,5644
04CBFW,Tranmere                        ,10458,5769,224,1342,4689
04CBFX,Upton                           ,13128,7487,148,942,5641
04CBFY,Wallasey                        ,12480,7238,98,536,5242
04CBSS,Shipping                        ,0,0,0,0,0
05CCFA,Ardsley                         ,7717,4364,175,681,3353
05CCFB,Athersley                       ,6791,3320,158,708,3471
05CCFC,Brierley                        ,7545,3841,137,726,3704
05CCFD,Central                         ,9009,5723,185,675,3286
05CCFE,Cudworth                        ,8148,4589,143,685,3559
05CCFF,Darfield                        ,8224,4481,163,657,3743
05CCFG,Darton                          ,9683,5757,119,495,3926
05CCFH,Dearne South                    ,9294,4722,155,687,4572
05CCFJ,Dearne Thurnscoe                ,8525,3855,155,740,4670
05CCFK,Dodworth                        ,9471,5753,111,523,3718
05CCFL,Hoyland East                    ,8283,4589,165,582,3694
05CCFM,Hoyland West                    ,6888,3696,88,426,3192
05CCFN,Monk Bretton                    ,9129,5144,184,745,3985
05CCFP,North West                      ,7663,4334,127,552,3329
05CCFQ,Park                            ,6104,3347,125,521,2757
05CCFR,Penistone East                  ,7469,4417,67,256,3052
05CCFS,Penistone West                  ,8592,5472,105,305,3120
05CCFT,Royston                         ,8914,5255,124,596,3659
05CCFU,South West                      ,7950,4606,114,427,3344
05CCFW,Wombwell North                  ,5263,3024,80,452,2239
05CCFX,Wombwell South                  ,8500,4674,129,680,3826
05CCFY,Worsbrough                      ,8174,4288,142,628,3886
05CCSS,Shipping                        ,0,0,0,0,0
05CEFA,Adwick                          ,12469,6762,236,1105,5707
05CEFB,Armthorpe                       ,13333,8074,186,783,5259
05CEFC,Askern                          ,8973,5085,125,722,3888
05CEFD,Balby                           ,11013,6088,157,914,4925
05CEFE,Bentley Central                 ,9247,5038,163,967,4209
05CEFF,Bentley North Road              ,9345,5145,130,632,4200
05CEFG,Bessacarr                       ,11002,5875,97,544,5127
05CEFH,Central                         ,9308,5359,116,980,3949
05CEFJ,Conisbrough                     ,11654,5895,229,1126,5759
05CEFK,Edlington and Warmsworth        ,9532,5377,147,836,4155
05CEFL,Hatfield                        ,11914,7029,148,776,4885
05CEFM,Intake                          ,8695,4460,125,669,4235
05CEFN,Mexborough                      ,12153,6627,249,997,5526
05CEFP,Richmond                        ,10951,6774,124,501,4177
05CEFQ,Rossington                      ,9633,5443,138,772,4190
05CEFR,South East                      ,13489,8579,134,493,4910
05CEFS,Southern Parks                  ,11682,7079,88,430,4603
05CEFT,Stainforth                      ,12032,7061,150,901,4971
05CEFU,Thorne                          ,13194,7161,186,1081,6033
05CEFW,Town Field                      ,8980,5288,151,915,3692
05CEFX,Wheatley                        ,9244,5085,118,750,4159
05CESS,Shipping                        ,0,0,0,0,0
05CFFA,Anston and Woodsetts            ,9612,6240,72,448,3372
05CFFB,AstonOrgreave and Ulley         ,11872,7575,129,711,4297
05CFFC,Boston                          ,8265,4682,101,641,3583
05CFFD,BramleyRavenfield and Wickersle ,13751,8692,132,608,5059
05CFFE,BramptonMelton and Wentworth    ,7108,3868,106,503,3240
05CFFF,BrinsworthCatcliffe and Treeton ,10158,6655,136,643,3503
05CFFG,Broom                           ,8219,4925,72,292,3294
05CFFH,Central                         ,6388,3734,111,662,2654
05CFFJ,DaltonHooton Roberts and Thrybe ,10853,6217,176,1054,4636
05CFFK,Greasebrough                    ,7628,4183,80,605,3445
05CFFL,Herringthorpe                   ,7638,3550,194,903,4088
05CFFM,Kimberworth                     ,8820,5608,118,609,3212
05CFFN,Kiveton Park                    ,7846,4615,67,389,3231
05CFFP,Maltby                          ,13165,7924,245,1009,5241
05CFFQ,Park                            ,7329,4329,142,688,3000
05CFFR,Rawmarsh East                   ,8215,4741,122,664,3474
05CFFS,Rawmarsh West                   ,8027,4437,116,522,3590
05CFFT,St.John's                       ,8614,5159,96,704,3455
05CFFU,Swinton                         ,9639,5513,140,605,4126
05CFFW,Thorpe Hesley                   ,8614,5122,99,568,3492
05CFFX,Thurcroft and Whiston           ,8544,5006,105,517,3538
05CFFY,Wath                            ,8818,4730,125,654,4088
05CFSS,Shipping                        ,0,0,0,0,0
05CGFA,Beauchief                       ,15157,8981,143,612,6176
05CGFB,Birley                          ,15733,8860,158,993,6873
05CGFC,Brightside                      ,13029,8596,183,1058,4433
05CGFD,Broomhill                       ,10789,6140,76,491,4649
05CGFE,Burngreave                      ,11630,6280,239,1538,5350
05CGFF,Castle                          ,10872,6201,231,1480,4671
05CGFG,Chapel Green                    ,18691,12550,237,961,6141
05CGFH,Darnall                         ,14684,8360,189,1253,6324
05CGFJ,Dore                            ,16016,8577,107,625,7439
05CGFK,Ecclesall                       ,15663,9690,95,465,5973
05CGFL,Firth Park                      ,13697,7225,219,1396,6472
05CGFM,Hallam                          ,14525,8577,69,399,5948
05CGFN,Handsworth                      ,14881,8109,138,852,6772
05CGFP,Heeley                          ,14481,9011,169,1153,5470
05CGFQ,Hillsborough                    ,15274,9600,163,816,5674
05CGFR,Intake                          ,15880,9593,166,1101,6287
05CGFS,Manor                           ,9817,4531,148,1126,5286
05CGFT,Mosborough                      ,24783,16358,260,1424,8425
05CGFU,Nether Edge                     ,12505,7665,120,858,4840
05CGFW,Nether Shire                    ,12896,6684,169,1083,6212
05CGFX,Netherthorpe                    ,11922,6742,225,1518,5180
05CGFY,Norton                          ,13077,6487,137,977,6590
05CGFZ,Owlerton                        ,12692,7613,157,1055,5079
05CGGA,Park                            ,12798,6736,220,1650,6062
05CGGB,Sharrow                         ,10911,5905,171,1356,5006
05CGGC,Southey Green                   ,12131,6171,180,1323,5960
05CGGD,South Wortley                   ,19168,11970,160,744,7198
05CGGE,Stocksbridge                    ,11043,6687,119,565,4356
05CGGF,Walkley                         ,14289,9113,157,829,5176
05CGSS,Shipping                        ,0,0,0,0,0
06CHFA,Bede                            ,6705,3883,127,891,2822
06CHFB,Bensham                         ,5822,3145,114,722,2677
06CHFC,Birtley                         ,6670,4059,80,379,2611
06CHFD,Blaydon                         ,7282,4315,96,604,2967
06CHFE,Chopwell and Rowlands Gill      ,7778,4381,86,490,3397
06CHFF,Chowdene                        ,7592,4357,61,433,3235
06CHFG,Crawcrook and Greenside         ,7455,4705,63,320,2750
06CHFH,Deckham                         ,6040,3381,100,555,2659
06CHFJ,Dunston                         ,7803,4737,95,555,3066
06CHFK,Felling                         ,6978,3716,156,855,3262
06CHFL,High Fell                       ,6814,3582,108,619,3232
06CHFM,Lamesley                        ,6879,3761,103,519,3118
06CHFN,Leam                            ,7985,4609,168,669,3376
06CHFP,Low Fell                        ,8045,4855,45,294,3190
06CHFQ,Pelaw and Heworth               ,7023,3932,98,490,3091
06CHFR,Ryton                           ,7327,4339,73,357,2988
06CHFS,Saltwell                        ,7216,4303,95,638,2913
06CHFT,Teams                           ,7604,4018,113,800,3586
06CHFU,Whickham North                  ,8465,4932,67,433,3533
06CHFW,Whickham South                  ,8923,5996,65,334,2927
06CHFX,Winlaton                        ,6862,3877,77,295,2985
06CHFY,Wrekendyke                      ,8160,4861,124,527,3299
06CHSS,Shipping                        ,0,0,0,0,0
06CJFA,Benwell                         ,7197,4105,137,958,3092
06CJFB,Blakelaw                        ,9728,5939,138,804,3789
06CJFC,Byker                           ,7291,3804,122,801,3487
06CJFD,Castle                          ,9083,5811,65,394,3272
06CJFE,Dene                            ,10510,6046,87,394,4464
06CJFF,Denton                          ,8553,4820,82,564,3733
06CJFG,Elswick                         ,7091,3717,142,958,3374
06CJFH,Fawdon                          ,7846,4244,137,728,3602
06CJFJ,Fenham                          ,8339,4283,115,581,4056
06CJFK,Grange                          ,9776,5371,91,411,4405
06CJFL,Heaton                          ,7958,4715,76,494,3243
06CJFM,Jesmond                         ,8544,5254,69,472,3290
06CJFN,Kenton                          ,7938,4098,84,676,3840
06CJFP,Lemington                       ,8178,5335,83,557,2843
06CJFQ,Monkchester                     ,7054,3573,121,986,3481
06CJFR,Moorside                        ,6894,3196,120,688,3698
06CJFS,Newburn                         ,7599,4470,61,589,3129
06CJFT,Sandyford                       ,8120,4493,108,684,3627
06CJFU,Scotswood                       ,6582,3450,100,962,3132
06CJFW,South Gosforth                  ,8123,4815,46,290,3308
06CJFX,Walker                          ,7029,3670,144,1096,3359
06CJFY,Walkergate                      ,8581,4973,92,622,3608
06CJFZ,West City                       ,6217,3330,159,1284,2887
06CJGA,Westerhope                      ,10464,6697,71,401,3767
06CJGB,Wingrove                        ,7638,4144,102,621,3494
06CJGC,Woolsington                     ,6642,3737,96,743,2905
06CJSS,Shipping                        ,0,0,0,0,0
06CKFA,Battle Hill                     ,9619,6364,119,607,3255
06CKFB,Benton                          ,6999,3844,63,383,3155
06CKFC,Camperdown                      ,7273,4472,89,528,2801
06CKFD,Chirton                         ,7004,3982,120,710,3022
06CKFE,Collingwood                     ,8147,4611,127,636,3536
06CKFF,Cullercoats                     ,8116,4185,64,282,3931
06CKFG,Holystone                       ,9368,5844,104,479,3524
06CKFH,Howdon                          ,6727,3571,115,610,3156
06CKFJ,Longbenton                      ,6405,3390,95,696,3015
06CKFK,Monkseaton                      ,7532,4361,67,254,3171
06CKFL,North Shields                   ,8126,4759,87,412,3367
06CKFM,Northumberland                  ,9512,6068,105,527,3444
06CKFN,Riverside                       ,6888,3724,154,890,3164
06CKFP,St.Mary's                       ,7690,4523,60,212,3167
06CKFQ,Seatonville                     ,7424,4269,85,340,3155
06CKFR,Tynemouth                       ,7393,4221,72,409,3172
06CKFS,Valley                          ,7571,4261,104,449,3310
06CKFT,Wallsend                        ,7554,4276,112,611,3278
06CKFU,Weetslade                       ,7909,4570,67,296,3339
06CKFW,Whitley Bay                     ,7558,4349,91,419,3209
06CKSS,Shipping                        ,0,0,0,0,0
06CLFA,All Saints                      ,6294,3554,119,693,2740
06CLFB,Beacon and Bents                ,6141,3512,100,684,2629
06CLFC,Bede                            ,6234,3140,145,786,3094
06CLFD,Biddick Hall                    ,5759,2950,115,555,2809
06CLFE,Boldon Colliery                 ,6957,4042,117,493,2915
06CLFF,Cleadon and East Boldon         ,7091,4270,44,226,2821
06CLFG,Cleadon Park                    ,5610,2784,115,555,2826
06CLFH,Fellgate and Hedworth           ,6927,4306,135,609,2621
06CLFJ,Harton                          ,5834,2643,98,410,3191
06CLFK,Hebburn Quay                    ,5735,3540,69,492,2195
06CLFL,Hebburn South                   ,5006,2472,70,367,2534
06CLFM,Horsley Hill                    ,6550,3485,93,489,3065
06CLFN,Monkton                         ,6618,3759,93,549,2859
06CLFP,Primrose                        ,6996,3954,147,664,3042
06CLFQ,Rekendyke                       ,5964,3120,95,670,2844
06CLFR,Tyne Dock and Simonside         ,5043,2715,103,499,2328
06CLFS,Westoe                          ,6265,3916,61,340,2349
06CLFT,West Park                       ,6099,3575,71,393,2524
06CLFU,Whitburn and Marsden            ,6007,3200,100,396,2807
06CLFW,Whiteleas                       ,6148,3299,87,535,2849
06CLSS,Shipping                        ,0,0,0,0,0
06CMFA,Castletown                      ,7857,4063,166,786,3794
06CMFB,Central                         ,8726,4936,198,974,3790
06CMFC,Colliery                        ,7927,4024,169,730,3903
06CMFD,Eppleton                        ,8913,4935,118,640,3978
06CMFE,Fulwell                         ,8521,4981,80,346,3540
06CMFF,Grindon                         ,8734,4490,231,1043,4244
06CMFG,Hendon                          ,8730,4943,190,849,3787
06CMFH,Hetton                          ,9496,4932,138,651,4564
06CMFJ,Houghton                        ,8874,5015,110,628,3859
06CMFK,Pallion                         ,9160,5100,187,716,4060
06CMFL,Ryhope                          ,10235,5703,206,787,4532
06CMFM,St.Chad's                       ,8704,4531,139,606,4173
06CMFN,St.Michael's                    ,8929,5199,121,437,3730
06CMFP,St.Peter's                      ,7916,4369,134,583,3547
06CMFQ,Shiney Row                      ,8973,5096,163,690,3877
06CMFR,Silksworth                      ,10255,6060,173,692,4195
06CMFS,South Hylton                    ,8359,4328,252,1104,4031
06CMFT,Southwick                       ,7693,3951,191,928,3742
06CMFU,Thorney Close                   ,8892,4569,304,1226,4323
06CMFW,Thornholme                      ,8182,4733,174,855,3449
06CMFX,Town End Farm                   ,6899,3923,171,992,2976
06CMFY,Washington East                 ,11205,7239,182,713,3966
06CMFZ,Washington North                ,9228,5572,177,749,3656
06CMGA,Washington South                ,14168,9853,200,857,4315
06CMGB,Washington West                 ,9971,6589,164,723,3382
06CMSS,Shipping                        ,0,0,0,0,0
07CNFA,Acock's Green                   ,20696,12675,180,1476,8021
07CNFB,Aston                           ,18438,9887,356,3205,8551
07CNFC,Bartley Green                   ,17216,10279,184,1437,6937
07CNFD,Billesley                       ,21306,12326,157,1397,8980
07CNFE,Bournville                      ,19466,12147,157,1078,7319
07CNFF,Brandwood                       ,21117,12613,199,1466,8504
07CNFG,Edgbaston                       ,17091,10174,214,1418,6917
07CNFH,Erdington                       ,19606,11905,182,1416,7701
07CNFJ,Fox Hollies                     ,18008,10423,177,1458,7585
07CNFK,Hall Green                      ,19799,12207,136,880,7592
07CNFL,Handsworth                      ,17327,9781,316,2777,7546
07CNFM,Harborne                        ,17856,10540,133,973,7316
07CNFN,Hodge Hill                      ,19950,12040,171,1644,7910
07CNFP,Kingsbury                       ,15384,8878,202,1834,6506
07CNFQ,King's Norton                   ,17509,10538,192,1512,6971
07CNFR,Kingstanding                    ,21087,11711,246,2135,9376
07CNFS,Ladywood                        ,19059,11486,368,2852,7573
07CNFT,Longbridge                      ,18081,11074,192,1415,7007
07CNFU,Moseley                         ,17533,10590,159,1346,6943
07CNFW,Nechells                        ,15777,8473,280,2468,7304
07CNFX,Northfield                      ,19565,12334,171,1022,7231
07CNFY,Oscott                          ,17925,10901,140,895,7024
07CNFZ,Perry Barr                      ,17961,11481,91,727,6480
07CNGA,Quinton                         ,16528,9870,143,847,6658
07CNGB,Sandwell                        ,20362,12481,247,1904,7881
07CNGC,Selly Oak                       ,17648,10454,130,843,7194
07CNGD,Shard End                       ,18873,9583,188,1528,9290
07CNGE,Sheldon                         ,17101,9648,132,842,7453
07CNGF,Small Heath                     ,21329,11386,380,2815,9943
07CNGG,Soho                            ,19599,11553,397,2894,8046
07CNGH,Sparkbrook                      ,17349,9223,369,3010,8126
07CNGJ,Sparkhill                       ,18527,10701,286,2412,7826
07CNGK,Stockland Green                 ,19185,11818,197,1696,7367
07CNGL,Sutton Four Oaks                ,25003,15294,98,723,9709
07CNGM,Sutton New Hall                 ,24977,16245,134,964,8732
07CNGN,Sutton Vesey                    ,23552,14821,127,757,8731
07CNGP,Washwood Heath                  ,20121,11001,281,2251,9120
07CNGQ,Weoley                          ,16925,9743,192,1321,7182
07CNGR,Yardley                         ,18556,11002,169,1386,7554
07CNSS,Shipping                        ,0,0,0,0,0
07CQFA,Bablake                         ,12688,7231,56,437,5457
07CQFB,Binley and Willenhall           ,14318,8621,147,1250,5697
07CQFC,Cheylesmore                     ,11839,7093,96,583,4746
07CQFD,Earlsdon                        ,13068,7795,71,536,5273
07CQFE,Foleshill                       ,12769,6901,173,1670,5868
07CQFF,Henley                          ,13143,8308,155,1310,4835
07CQFG,Holbrook                        ,13808,8719,127,1063,5089
07CQFH,Longford                        ,13387,7960,165,1094,5427
07CQFJ,Lower Stoke                     ,12422,7234,102,923,5188
07CQFK,Radford                         ,13116,7425,162,1184,5691
07CQFL,St. Michael's                   ,10938,6069,199,1479,4869
07CQFM,Sherbourne                      ,12811,8018,114,741,4793
07CQFN,Upper Stoke                     ,13639,8088,128,1097,5551
07CQFP,Wainbody                        ,10534,6161,55,286,4373
07CQFQ,Westwood                        ,11125,6310,110,750,4815
07CQFR,Whoberley                       ,13042,8347,110,792,4695
07CQFS,Woodlands                       ,15106,9826,115,768,5280
07CQFT,Wyken                           ,14127,9124,117,824,5003
07CQSS,Shipping                        ,0,0,0,0,0
07CRFA,Amblecote                       ,14212,10745,103,624,3467
07CRFB,Belle Vale and Hasbury          ,10048,6230,78,472,3818
07CRFC,Brierley Hill                   ,7791,4589,98,699,3202
07CRFD,Brockmoor and Pensett           ,10405,6421,113,796,3984
07CRFE,Castle and Priory               ,9188,5306,133,927,3882
07CRFF,Coseley East                    ,9407,5825,87,617,3582
07CRFG,Coseley West                    ,9196,5633,73,473,3563
07CRFH,Gornal                          ,13141,8628,130,746,4513
07CRFJ,Halesowen North                 ,9885,6197,65,469,3688
07CRFK,Halesowen South                 ,10172,6374,38,302,3798
07CRFL,Hayley Green                    ,9504,5956,70,399,3548
07CRFM,Kingswinford North and Wall Heat,10403,6936,59,371,3467
07CRFN,Kingswinford South              ,10398,6840,81,387,3558
07CRFP,Lye and Wollescote              ,9716,5929,87,754,3787
07CRFQ,Netherton and Woodside          ,7302,4476,82,650,2826
07CRFR,Norton                          ,10019,5984,41,353,4035
07CRFS,Pedmore and Stourbridge East    ,10492,6536,50,358,3956
07CRFT,Quarry Bank and Cradley         ,12546,8397,113,796,4149
07CRFU,St.Andrews                      ,9627,6005,90,632,3622
07CRFW,St.James's                      ,9792,5729,103,829,4063
07CRFX,St.Thomas's                     ,9732,5421,117,919,4311
07CRFY,Sedgley                         ,10483,6918,67,340,3565
07CRFZ,Wollaston and Stourbridge West  ,9984,6111,74,448,3873
07CRGA,Wordsley                        ,11856,8420,104,486,3436
07CRSS,Shipping                        ,0,0,0,0,0
07CSFA,Abbey                           ,9499,6039,60,457,3460
07CSFB,Blackheath                      ,10134,5790,78,687,4344
07CSFC,Bristnall                       ,10250,5858,119,678,4392
07CSFD,Charlemont                      ,9460,5939,67,510,3521
07CSFE,Cradley Heath and Old Hill      ,9761,5665,71,668,4096
07CSFF,Friar Park                      ,9492,5700,107,990,3792
07CSFG,Great Barr                      ,10294,6377,78,633,3917
07CSFH,Great Bridge                    ,8750,4902,112,855,3848
07CSFJ,Greets Green and Lyng           ,9500,5244,81,867,4256
07CSFK,Hateley Heath                   ,10292,5862,122,937,4430
07CSFL,Langley                         ,10128,6097,89,534,4031
07CSFM,Newton                          ,10073,6519,72,499,3554
07CSFN,Oldbury                         ,8910,5397,108,796,3513
07CSFP,Old Warley                      ,9354,5221,71,469,4133
07CSFQ,Princes End                     ,10360,6655,134,1193,3705
07CSFR,Rowley                          ,9851,6075,111,693,3776
07CSFS,St.Pauls                        ,8837,5236,110,970,3601
07CSFT,Smethwick                       ,9258,5092,93,810,4166
07CSFU,Soho and Victoria               ,6343,3404,100,881,2939
07CSFW,Tipton Green                    ,10846,6411,101,1027,4435
07CSFX,Tividale                        ,10106,6419,90,610,3687
07CSFY,Wednesbury North                ,9796,5576,103,789,4220
07CSFZ,Wednesbury South                ,9947,5869,116,767,4078
07CSGA,West Bromwich Central           ,9155,5417,87,851,3738
07CSSS,Shipping                        ,0,0,0,0,0
07CTFA,Bickenhill                      ,10601,7037,86,479,3564
07CTFB,Castle Bromwich                 ,9970,6722,58,374,3248
07CTFC,Chelmsley Wood                  ,8943,5832,135,970,3111
07CTFD,Elmdon                          ,8576,5198,49,271,3378
07CTFE,Fordbridge                      ,7169,4682,112,756,2487
07CTFF,Kingshurst                      ,6622,4105,85,571,2517
07CTFG,Knowle                          ,8996,5540,26,221,3456
07CTFH,Lyndon                          ,8382,5230,46,358,3152
07CTFJ,Meriden                         ,8799,5521,39,248,3278
07CTFK,Olton                           ,9548,5917,46,319,3631
07CTFL,Packwood                        ,9706,6242,44,219,3464
07CTFM,St.Alphege                      ,10172,6261,30,216,3911
07CTFN,Shirley East                    ,9410,5781,47,266,3629
07CTFP,Shirley South                   ,13336,9208,56,432,4128
07CTFQ,Shirley West                    ,9585,6333,55,324,3252
07CTFR,Silhill                         ,10393,6333,54,336,4060
07CTFS,Smith's Wood                    ,9377,6085,115,1000,3292
07CTSS,Shipping                        ,0,0,0,0,0
07CUFA,Aldridge Central and South      ,10916,6797,72,458,4119
07CUFB,Aldridge North and Walsall Wood ,10742,6936,72,539,3806
07CUFC,Bentley and Darlaston North     ,10673,6199,123,823,4474
07CUFD,Birchills Leamore               ,10170,5840,137,915,4330
07CUFE,Blakenall                       ,9469,5313,170,1231,4156
07CUFF,Bloxwich East                   ,9642,5297,101,697,4345
07CUFG,Bloxwich West                   ,11489,6801,120,885,4688
07CUFH,Brownhills                      ,9297,5826,100,749,3471
07CUFJ,Darlaston South                 ,10156,5771,125,1011,4385
07CUFK,Hatherton Rushall               ,11104,6801,110,622,4303
07CUFL,Paddock                         ,11210,6955,66,381,4255
07CUFM,Palfrey                         ,10461,5874,169,917,4587
07CUFN,Pelsall                         ,11617,7286,122,544,4331
07CUFP,Pheasey                         ,8231,5415,46,354,2816
07CUFQ,Pleck                           ,8606,4729,128,832,3877
07CUFR,St.Matthew's                    ,8813,5075,144,1053,3738
07CUFS,Short Heath                     ,10103,6701,84,600,3402
07CUFT,Streetly                        ,11471,7900,58,346,3571
07CUFU,Willenhall North                ,10103,6809,105,532,3294
07CUFW,Willenhall South                ,10607,6622,118,805,3985
07CUSS,Shipping                        ,0,0,0,0,0
07CWFA,Bilston East                    ,8930,5033,151,933,3897
07CWFB,Bilston North                   ,11112,6690,128,961,4422
07CWFC,Blakenhall                      ,9148,5195,86,871,3953
07CWFD,Bushbury                        ,9621,5794,109,723,3827
07CWFE,East Park                       ,9216,5121,136,916,4095
07CWFF,Ettingshall                     ,8516,4707,122,948,3809
07CWFG,Fallings Park                   ,8854,4881,97,662,3973
07CWFH,Graiseley                       ,9612,5485,152,928,4127
07CWFJ,Heath Town                      ,8600,4989,131,1204,3611
07CWFK,Low Hill                        ,9619,5504,155,1316,4115
07CWFL,Merry Hill                      ,9633,5418,83,476,4215
07CWFM,Oxley                           ,9440,5832,122,642,3608
07CWFN,Park                            ,10739,6378,97,783,4361
07CWFP,Penn                            ,9918,6112,56,407,3806
07CWFQ,St.Peter's                      ,10073,5821,212,1399,4252
07CWFR,Spring Vale                     ,10692,6503,117,681,4189
07CWFS,Tettenhall Regis                ,9249,5547,89,546,3702
07CWFT,Tettenhall Wightwick            ,9297,5102,58,317,4195
07CWFU,Wednesfield North               ,9831,6417,103,628,3414
07CWFW,Wednesfield South               ,8930,5498,91,591,3432
07CWSS,Shipping                        ,0,0,0,0,0
08CXFA,Baildon                         ,12494,7840,83,390,4654
08CXFB,Bingley                         ,10574,6494,59,367,4080
08CXFC,Bingley Rural                   ,12186,8090,74,365,4096
08CXFD,Bolton                          ,10469,6798,92,454,3671
08CXFE,Bowling                         ,12915,7509,166,1423,5406
08CXFF,Bradford Moor                   ,10956,6008,181,1475,4948
08CXFG,Clayton                         ,10357,6551,64,465,3806
08CXFH,Craven                          ,11639,7241,63,311,4398
08CXFJ,Eccleshill                      ,11076,7155,104,851,3921
08CXFK,Great Horton                    ,11666,7392,96,717,4274
08CXFL,Heaton                          ,12512,7140,111,906,5372
08CXFM,Idle                            ,11431,7343,77,625,4088
08CXFN,Ilkley                          ,11300,5998,41,240,5302
08CXFP,Keighley North                  ,11531,7245,108,661,4286
08CXFQ,Keighley South                  ,10070,5803,118,700,4267
08CXFR,Keighley West                   ,12343,7633,105,817,4710
08CXFS,Little Horton                   ,11815,6302,167,1545,5513
08CXFT,Odsal                           ,13134,8204,134,797,4930
08CXFU,Queensbury                      ,12897,8478,110,631,4419
08CXFW,Rombalds                        ,12307,7482,57,288,4825
08CXFX,Shipley East                    ,11211,6912,107,733,4299
08CXFY,Shipley West                    ,12123,7195,89,472,4928
08CXFZ,Thornton                        ,10937,7043,79,712,3894
08CXGA,Toller                          ,11964,6514,151,1302,5450
08CXGB,Tong                            ,10314,6165,117,1069,4149
08CXGC,Undercliffe                     ,11630,6873,149,1119,4757
08CXGD,University                      ,12671,5967,190,1866,6704
08CXGE,Wibsey                          ,10589,6803,101,680,3786
08CXGF,Worth Valley                    ,11118,7569,85,375,3549
08CXGG,Wyke                            ,13108,8644,118,765,4464
08CXSS,Shipping                        ,0,0,0,0,0
08CYFA,Brighouse                       ,8002,4994,43,295,3008
08CYFB,Calder Valley                   ,8930,5720,70,449,3210
08CYFC,Elland                          ,8579,5178,64,463,3401
08CYFD,Greetland and Stainland         ,8980,6025,63,310,2955
08CYFE,Hipperholme and Lightcliffe     ,8098,5085,40,241,3013
08CYFF,Illingworth                     ,7754,5142,83,488,2612
08CYFG,Luddendenfoot                   ,8609,5412,62,420,3197
08CYFH,Mixenden                        ,8264,5199,109,767,3065
08CYFJ,Northowram and Shelf            ,8575,5636,40,209,2939
08CYFK,Ovenden                         ,8089,4974,99,728,3115
08CYFL,Rastrick                        ,8174,5325,49,343,2849
08CYFM,Ryburn                          ,8780,5616,75,396,3164
08CYFN,St.John's                       ,8216,4413,104,956,3803
08CYFP,Skircoat                        ,9108,5468,51,306,3640
08CYFQ,Sowerby Bridge                  ,8010,5101,92,412,2909
08CYFR,Todmorden                       ,8218,5068,74,500,3150
08CYFS,Town                            ,8981,5327,98,614,3654
08CYFT,Warley                          ,8309,5242,57,424,3067
08CYSS,Shipping                        ,0,0,0,0,0
08CZFA,Almondbury                      ,10181,5951,87,557,4230
08CZFB,Batley East                     ,12579,7444,140,955,5135
08CZFC,Batley West                     ,13883,8675,137,983,5208
08CZFD,Birkby                          ,11449,6716,135,723,4733
08CZFE,Birstall and Birkenshaw         ,14421,9617,92,611,4804
08CZFF,Cleckheaton                     ,12073,7806,81,498,4267
08CZFG,Colne Valley West               ,10953,6887,91,466,4066
08CZFH,Crosland Moor                   ,12020,6925,136,762,5095
08CZFJ,Dalton                          ,12547,7803,155,573,4744
08CZFK,Deighton                        ,10089,6031,191,1026,4058
08CZFL,Denby Dale                      ,13155,8309,77,392,4846
08CZFM,Dewsbury East                   ,11490,6837,105,738,4653
08CZFN,Dewsbury West                   ,12494,7434,115,871,5060
08CZFP,Golcar                          ,12796,8436,115,610,4360
08CZFQ,Heckmondwike                    ,12720,8261,77,503,4459
08CZFR,Holme Valley North              ,11924,7482,115,432,4442
08CZFS,Holme Valley South              ,12965,8587,99,449,4378
08CZFT,Kirkburton                      ,12182,7746,89,318,4436
08CZFU,Lindley                         ,13037,8323,96,388,4714
08CZFW,Mirfield                        ,12819,8134,91,393,4685
08CZFX,Newsome                         ,10800,6147,154,774,4653
08CZFY,Paddock                         ,11577,6513,133,748,5064
08CZFZ,Spen                            ,12966,8313,97,704,4653
08CZGA,Thornhill                       ,12516,7332,134,953,5184
08CZSS,Shipping                        ,0,0,0,0,0
08DAFA,Aireborough                     ,19918,12659,59,545,7259
08DAFB,Armley                          ,16529,10669,123,1094,5860
08DAFC,Barwick and Kippax              ,18124,11521,105,731,6603
08DAFD,Beeston                         ,13464,8083,117,1008,5381
08DAFE,Bramley                         ,16670,10211,127,1098,6459
08DAFF,Burmantofts                     ,14779,8712,193,1456,6067
08DAFG,Chapel Allerton                 ,16803,10226,287,1756,6577
08DAFH,City and Holbeck                ,16587,10009,199,1676,6578
08DAFJ,Cookridge                       ,16996,10107,62,519,6889
08DAFK,Garforth and Swillington        ,18932,12334,100,604,6598
08DAFL,Halton                          ,17713,11448,83,522,6265
08DAFM,Harehills                       ,15607,9227,237,1879,6380
08DAFN,Headingley                      ,13709,7827,178,1115,5882
08DAFP,Horsforth                       ,17286,11000,68,513,6286
08DAFQ,Hunslet                         ,11510,6632,108,899,4878
08DAFR,Kirkstall                       ,15581,9166,151,1105,6415
08DAFS,Middleton                       ,14022,8358,126,1144,5664
08DAFT,Moortown                        ,16452,9309,78,574,7143
08DAFU,Morley North                    ,17986,12034,110,631,5952
08DAFW,Morley South                    ,20284,13387,148,847,6897
08DAFX,North                           ,16923,10041,63,495,6882
08DAFY,Otley and Wharfedale            ,18719,11606,63,483,7113
08DAFZ,Pudsey North                    ,18343,12235,82,600,6108
08DAGA,Pudsey South                    ,16928,10738,124,807,6190
08DAGB,Richmond Hill                   ,15404,9032,179,1510,6372
08DAGC,Rothwell                        ,16251,10317,91,664,5934
08DAGD,Roundhay                        ,16729,10342,92,592,6387
08DAGE,Seacroft                        ,14152,7534,196,1328,6618
08DAGF,University                      ,14258,7749,248,1624,6509
08DAGG,Weetwood                        ,13670,7959,81,554,5711
08DAGH,Wetherby                        ,20305,12452,52,470,7853
08DAGJ,Whinmoor                        ,14990,9326,138,826,5664
08DAGK,Wortley                         ,18358,11688,132,1082,6670
08DASS,Shipping                        ,0,0,0,0,0
08DBFA,Castleford Ferry Fryston        ,10570,5746,122,873,4824
08DBFB,Castleford Glasshoughton        ,10975,6559,103,712,4416
08DBFC,Castleford Whitwood             ,10133,5757,85,632,4376
08DBFD,Crofton and Ackworth            ,11879,7444,109,511,4435
08DBFE,Featherstone                    ,11297,6475,111,742,4822
08DBFF,Hemsworth                       ,11654,6603,123,885,5051
08DBFG,Horbury                         ,11556,7338,78,538,4218
08DBFH,Knottingley                     ,11409,6910,139,833,4499
08DBFJ,Normanton and Sharlston         ,12255,7251,117,726,5004
08DBFK,Ossett                          ,12170,7957,76,567,4213
08DBFL,Pontefract North                ,11983,7182,125,717,4801
08DBFM,Pontefract South                ,11504,6796,134,528,4708
08DBFN,South Elmsall                   ,11438,6403,130,814,5035
08DBFP,South Kirkby                    ,11035,5943,154,846,5092
08DBFQ,Stanley and Altofts             ,13478,8680,81,513,4798
08DBFR,Stanley and Wrenthorpe          ,13293,8518,85,508,4775
08DBFS,Wakefield Central               ,11828,7066,131,913,4762
08DBFT,Wakefield East                  ,11981,6697,141,926,5284
08DBFU,Wakefield North                 ,11924,7315,235,874,4609
08DBFW,Wakefield Rural                 ,12855,8438,88,553,4417
08DBFX,Wakefield South                 ,12151,7524,82,476,4627
08DBSS,Shipping                        ,0,0,0,0,0
09DCFA,Abbey                           ,4392,2478,43,326,1914
09DCFB,Bathwick                        ,3810,1791,25,128,2019
09DCFC,Bloomfield                      ,4153,2611,27,168,1542
09DCFD,Combe Down                      ,4012,2148,25,178,1864
09DCFE,Kingsmead                       ,4172,2562,31,255,1610
09DCFF,Lambridge                       ,3155,1906,23,164,1249
09DCFG,Lansdown                        ,3966,2361,21,140,1605
09DCFH,Lyncombe                        ,4288,2394,17,120,1894
09DCFJ,Newbridge                       ,4517,2642,27,148,1875
09DCFK,Oldfield                        ,4155,2413,22,170,1742
09DCFL,Southdown                       ,4338,2778,41,254,1560
09DCFM,Twerton                         ,3928,2316,25,332,1612
09DCFN,Walcot                          ,4128,2763,37,268,1365
09DCFP,Westmoreland                    ,4240,2787,30,222,1453
09DCFQ,Weston                          ,4164,2319,21,167,1845
09DCFR,Widcombe                        ,4191,2657,41,222,1534
09DCSS,Shipping                        ,0,0,0,0,0
09DDFA,Ashley                          ,9411,6245,240,1315,3166
09DDFB,Avonmouth                       ,7903,4851,46,416,3052
09DDFC,Bedminster                      ,9273,5722,36,455,3551
09DDFD,Bishopston                      ,9322,6198,68,430,3124
09DDFE,Bishopsworth                    ,7909,4671,53,531,3238
09DDFF,Brislington East                ,9463,5600,48,452,3863
09DDFG,Brislington West                ,9124,6214,42,429,2910
09DDFH,Cabot                           ,8644,5795,75,654,2849
09DDFJ,Clifton                         ,8817,5782,67,455,3035
09DDFK,Cotham                          ,9005,6246,86,523,2759
09DDFL,Easton                          ,8609,5659,76,711,2950
09DDFM,Eastville                       ,9152,5940,64,573,3212
09DDFN,Filwood                         ,7669,4499,90,900,3170
09DDFP,Frome Vale                      ,9439,4974,45,352,4465
09DDFQ,Hartcliffe                      ,8714,5294,74,647,3420
09DDFR,Henbury                         ,8396,4686,61,428,3710
09DDFS,Hengrove                        ,10778,7032,55,382,3746
09DDFT,Henleaze                        ,9087,5312,46,292,3775
09DDFU,Hillfields                      ,8580,5182,72,498,3398
09DDFW,Horfield                        ,8230,4810,65,347,3420
09DDFX,Kingsweston                     ,8233,4728,59,672,3505
09DDFY,Knowle                          ,8016,4649,72,677,3367
09DDFZ,Lawrence Hill                   ,9751,5383,123,1275,4368
09DDGA,Lockleaze                       ,7865,4567,52,547,3298
09DDGB,Redland                         ,9447,6346,97,546,3101
09DDGC,St.George East                  ,9040,6009,53,404,3031
09DDGD,St.George West                  ,8776,5402,56,544,3374
09DDGE,Southmead                       ,8737,5292,122,706,3445
09DDGF,Southville                      ,8650,5519,64,580,3131
09DDGG,Stockwood                       ,10482,6676,46,468,3806
09DDGH,Stoke Bishop                    ,8205,4352,32,268,3853
09DDGJ,Westbury-On-Trym                ,8533,4570,18,171,3963
09DDGK,Whitchurch Park                 ,8923,5717,68,821,3206
09DDGL,Windmill Hill                   ,10945,7191,109,885,3754
09DDSS,Shipping                        ,0,0,0,0,0
09DEFA,Badminton                       ,1756,1176,9,41,580
09DEFB,Bitton North Common             ,2786,2171,15,92,615
09DEFC,Bitton Oldland Common           ,2713,1880,17,97,833
09DEFD,Bitton South                    ,1506,1020,7,51,486
09DEFE,Blackhorse                      ,1293,759,5,59,534
09DEFF,Bromley Heath                   ,3944,2403,13,101,1541
09DEFG,Chase                           ,4024,2631,26,195,1393
09DEFH,Chiphouse                       ,4223,3100,35,179,1123
09DEFJ,Downend                         ,4247,2482,17,109,1765
09DEFK,Forest                          ,4208,2940,16,170,1268
09DEFL,Hanham                          ,4087,2415,26,140,1672
09DEFM,Hanham Abbots East              ,1622,1036,8,49,586
09DEFN,Hanham Abbots West              ,3121,1975,18,81,1146
09DEFP,Mangotsfield                    ,4171,2533,39,180,1638
09DEFQ,New Cheltenham                  ,4278,2906,37,216,1372
09DEFR,Oldland Barrs Court             ,3317,2559,12,89,758
09DEFS,Oldland Cadbury Heath           ,3969,2581,28,231,1388
09DEFT,Oldland Longwell Green          ,3459,2572,17,124,887
09DEFU,Siston                          ,1792,1098,19,78,694
09DEFW,Soundwell                       ,2819,1737,22,127,1082
09DEFX,Springfield                     ,1388,877,15,54,511
09DEFY,Staple Hill                     ,2897,1622,18,117,1275
09DEFZ,Woodstock                       ,4314,3103,28,184,1211
09DESS,Shipping                        ,0,0,0,0,0
09DFFA,Almondsbury                     ,6056,4477,27,225,1579
09DFFB,Alveston                        ,2979,1809,11,72,1170
09DFFC,Badminton                       ,1810,1184,7,52,626
09DFFD,Charfield                       ,2178,1538,12,50,640
09DFFE,Chipping Sodbury                ,3166,1979,14,131,1187
09DFFF,Dodington North                 ,6128,4824,46,273,1304
09DFFG,Filton Charborough              ,2565,1523,12,88,1042
09DFFH,Filton Conygre                  ,2788,1652,20,98,1136
09DFFJ,Filton Northville               ,2794,1660,13,106,1134
09DFFK,Frampton Cotterell Central      ,1654,1074,7,64,580
09DFFL,Frampton Cotterell East         ,1432,954,2,34,478
09DFFM,Frampton Cotterell West         ,1760,1245,11,49,515
09DFFN,Hawkesbury                      ,1267,809,5,36,458
09DFFP,Iron Acton                      ,1484,949,8,62,535
09DFFQ,Marshfield                      ,1585,1019,7,46,566
09DFFR,Oldbury-on-Severn               ,1149,752,2,23,397
09DFFS,Olveston                        ,1603,993,4,23,610
09DFFT,Patchway Callicroft             ,3445,2318,27,159,1127
09DFFU,Patchway Coniston               ,3108,2284,22,262,824
09DFFW,Patchway Stoke Lodge            ,2157,1469,9,65,688
09DFFX,Pilning and Severn Beach        ,2163,1510,27,98,653
09DFFY,Pucklechurch                    ,2279,1628,14,77,651
09DFFZ,Stoke Gifford North             ,3150,2284,31,114,866
09DFGA,Stoke Gifford South             ,6626,5165,25,165,1461
09DFGB,Thornbury North                 ,4514,2991,20,130,1523
09DFGC,Thornbury South                 ,5351,3670,24,178,1681
09DFGD,Westerleigh and Coalpit Heath   ,2556,1588,15,93,968
09DFGE,Wick and Abson                  ,1567,1017,7,52,550
09DFGF,Wickwar                         ,1932,1221,23,62,711
09DFGG,Winterbourne                    ,4384,2869,24,150,1515
09DFGH,Winterbourne Down and Hambrook  ,1421,864,7,40,557
09DFGJ,Winterbourne Frenchay           ,1585,850,2,27,735
09DFGK,Yate Central                    ,1262,874,12,49,388
09DFGL,Yate North                      ,6045,4487,36,175,1558
09DFGM,Yate South                      ,3496,2553,15,133,943
09DFGN,Yate Stanshawes                 ,1830,1447,17,74,383
09DFGP,Yate West                       ,2789,2087,10,153,702
09DFSS,Shipping                        ,0,0,0,0,0
09DGFA,Bathampton                      ,1345,702,3,35,643
09DGFB,Batheaston                      ,2252,1230,19,76,1022
09DGFC,Bathford                        ,1534,878,8,37,656
09DGFD,Cameley                         ,1774,1130,10,56,644
09DGFE,Camerton                        ,1145,740,8,50,405
09DGFF,Charlcombe                      ,0,0,0,0,0
09DGFG,Chew Magna                      ,1156,709,4,30,447
09DGFH,Chew Stoke                      ,1112,691,1,31,421
09DGFJ,Clutton                         ,1270,836,5,39,434
09DGFK,Compton Dando                   ,1441,944,2,39,497
09DGFL,Farmborough                     ,901,545,4,21,356
09DGFM,Freshford                       ,1163,642,2,32,521
09DGFN,Harptrees                       ,1230,762,5,33,468
09DGFP,High Littleton                  ,1484,933,5,45,551
09DGFQ,Hinton Charterhouse             ,1188,730,3,45,458
09DGFR,Keynsham East                   ,4532,2625,28,100,1907
09DGFS,Keynsham North                  ,2790,1648,14,117,1142
09DGFT,Keynsham South                  ,3261,1857,16,123,1404
09DGFU,Keynsham West                   ,2349,1601,12,101,748
09DGFW,Midsomer Norton North           ,3705,2479,19,114,1226
09DGFX,Midsomer Norton Redfield        ,3232,1973,25,93,1259
09DGFY,Newton St.Loe                   ,1901,1135,8,69,766
09DGFZ,Paulton                         ,3775,2487,26,114,1288
09DGGA,Peasedown St.John               ,3018,1936,14,156,1082
09DGGB,Publow                          ,1485,925,3,30,560
09DGGC,Radstock                        ,3921,2675,43,186,1246
09DGGD,Saltford                        ,3548,2077,23,72,1471
09DGGE,Stowey Sutton                   ,941,574,1,27,367
09DGGF,Timsbury                        ,1942,1209,13,45,733
09DGGG,Westfield                       ,5259,3703,29,167,1556
09DGSS,Shipping                        ,0,0,0,0,0
09DHFA,Backwell                        ,4625,2770,23,125,1855
09DHFB,Banwell                         ,5091,3050,22,189,2041
09DHFC,Blagdon                         ,1536,942,3,39,594
09DHFD,Churchill                       ,1608,967,4,36,641
09DHFE,Clevedon Central                ,3789,2383,14,124,1406
09DHFF,Clevedon East                   ,2716,1678,15,93,1038
09DHFG,Clevedon North                  ,1722,841,5,49,881
09DHFH,Clevedon South                  ,3753,2734,17,155,1019
09DHFJ,Clevedon Walton                 ,2537,1249,5,47,1288
09DHFK,Clevedon West                   ,2822,1878,6,90,944
09DHFL,Congresbury                     ,2715,1698,12,98,1017
09DHFM,Easton-in-Gordano               ,3994,2538,18,173,1456
09DHFN,Gordano                         ,2163,1398,10,54,765
09DHFP,Hutton                          ,2962,1582,17,82,1380
09DHFQ,Locking                         ,2851,1947,24,91,904
09DHFR,Long Ashton                     ,4048,2394,20,136,1654
09DHFS,Nailsea East                    ,6898,4670,19,159,2228
09DHFT,Nailsea North and West          ,6423,4095,28,191,2328
09DHFU,North Weston                    ,2601,1447,6,88,1154
09DHFW,Portishead Central              ,1813,1125,15,84,688
09DHFX,Portishead Coast                ,1934,1087,10,48,847
09DHFY,Portishead South                ,2317,1460,9,65,857
09DHFZ,Portishead West                 ,3379,2208,14,126,1171
09DHGA,Weston-Super-Mare Ashcombe      ,6765,3835,52,360,2930
09DHGB,Weston-Super-Mare East          ,7738,4215,39,287,3523
09DHGC,Weston-Super-Mare Ellenborough  ,6887,3397,52,435,3490
09DHGD,Weston-Super-Mare North         ,13111,8285,60,501,4826
09DHGE,Weston-Super-Mare South         ,5800,3190,60,525,2610
09DHGF,Weston-Super-Mare Uphill        ,6306,3208,43,241,3098
09DHGG,Weston-Super-Mare West          ,6687,3143,26,359,3544
09DHGH,Winford                         ,2352,1550,22,88,802
09DHGJ,Winscombe                       ,3567,2013,13,91,1554
09DHGK,Wraxall                         ,1860,1041,9,56,819
09DHGL,Wrington                        ,2088,1289,2,57,799
09DHGM,Yatton                          ,6592,4206,34,200,2386
09DHSS,Shipping                        ,0,0,0,0,0
10DJFA,Biscot                          ,7848,4518,64,870,3330
10DJFB,Bramingham                      ,9459,7106,54,534,2353
10DJFC,Challney                        ,8059,5356,37,472,2703
10DJFD,Crawley                         ,8140,5577,44,521,2563
10DJFE,Dallow                          ,7138,4384,50,793,2754
10DJFF,Farley                          ,7305,4362,44,617,2943
10DJFG,High Town                       ,7320,4841,40,572,2479
10DJFH,Icknield                        ,8876,5809,25,363,3067
10DJFJ,Leagrave                        ,8042,5412,44,564,2630
10DJFK,Lewsey                          ,9428,6271,43,726,3157
10DJFL,Limbury                         ,7492,5121,28,392,2371
10DJFM,Putteridge                      ,10837,8194,34,410,2643
10DJFN,Saints                          ,7670,4671,44,567,2999
10DJFP,South                           ,7809,4905,33,604,2904
10DJFQ,Stopsley                        ,7440,4677,43,486,2763
10DJFR,Sundon Park                     ,7866,5544,30,580,2322
10DJSS,Shipping                        ,0,0,0,0,0
10DKFA,Ampthill                        ,5016,3283,19,154,1733
10DKFB,Arlesey                         ,3452,2451,9,172,1001
10DKFC,Aspley                          ,2764,1794,2,88,970
10DKFD,Biggleswade Ivel                ,5120,3557,9,187,1563
10DKFE,Biggleswade Stratton            ,5126,3497,17,184,1629
10DKFF,Blunham                         ,1650,1010,5,52,640
10DKFG,Campton And Meppershall         ,2702,2075,168,51,627
10DKFH,Clifton And Henlow              ,4735,3432,29,141,1303
10DKFJ,Clophill                        ,1314,889,5,43,425
10DKFK,Cranfield                       ,3400,2196,17,99,1204
10DKFL,Flitton And Pulloxhill          ,1473,978,3,55,495
10DKFM,Flitwick East                   ,4133,2838,23,156,1295
10DKFN,Flitwick West                   ,4427,3341,5,124,1086
10DKFP,Harlington                      ,1845,1295,8,61,550
10DKFQ,Haynes And Houghton Conquest    ,1978,1330,8,70,648
10DKFR,Langford                        ,2237,1580,10,100,657
10DKFS,Marston                         ,3350,2284,24,126,1066
10DKFT,Maulden                         ,2144,1374,2,51,770
10DKFU,Northill                        ,1717,1186,6,57,531
10DKFW,Old Warden And Southill         ,1072,737,2,45,335
10DKFX,Potton                          ,3679,2606,10,125,1073
10DKFY,Sandy All Saints                ,2983,2070,10,149,913
10DKFZ,Sandy St.Swithuns               ,3856,2577,14,209,1279
10DKGA,Shefford                        ,2699,1794,10,87,905
10DKGB,Shillington and Stondon         ,2754,1842,10,83,912
10DKGC,Stotfold                        ,5398,3493,13,188,1905
10DKGD,Wensley                         ,1352,918,5,37,434
10DKGE,Westoning                       ,1427,974,9,46,453
10DKGF,Woburn                          ,1282,833,5,43,449
10DKGG,Wrest                           ,1678,1033,8,44,645
10DKSS,Shipping                        ,0,0,0,0,0
10DLFA,Brickhill                       ,6168,4249,25,222,1919
10DLFB,Bromham                         ,4262,2431,16,104,1831
10DLFC,Carlton                         ,1766,1124,6,50,642
10DLFD,Castle                          ,4798,2903,24,251,1895
10DLFE,Cauldwell                       ,6489,4100,63,550,2389
10DLFF,Clapham                         ,2892,1798,9,120,1094
10DLFG,De Parys                        ,5955,3841,32,262,2114
10DLFH,Eastcotts                       ,2236,1531,12,96,705
10DLFJ,Felmersham                      ,1818,1173,4,54,645
10DLFK,Goldington                      ,5550,3575,28,355,1975
10DLFL,Great Barford                   ,2024,1380,14,66,644
10DLFM,Harpur                          ,5925,3696,35,410,2229
10DLFN,Harrold                         ,2147,1319,7,78,828
10DLFP,Kempston East                   ,7630,5515,34,301,2115
10DLFQ,Kempston Rural                  ,2141,1369,13,65,772
10DLFR,Kempston West                   ,6397,4296,46,313,2101
10DLFS,Kingsbrook                      ,5532,3230,31,433,2302
10DLFT,Newnham                         ,4015,2577,17,133,1438
10DLFU,Oakley                          ,1799,1297,6,40,502
10DLFW,Putnoe                          ,5761,3756,20,161,2005
10DLFX,Queens Park                     ,6507,4052,38,605,2455
10DLFY,Renhold                         ,1864,1156,9,50,708
10DLFZ,Riseley                         ,2139,1405,4,56,734
10DLGA,Roxton                          ,1963,1305,15,68,658
10DLGB,Sharnbrook                      ,2096,1316,9,45,780
10DLGC,Wilshamstead                    ,2414,1476,10,99,938
10DLGD,Wootton                         ,3766,2543,22,108,1223
10DLSS,Shipping                        ,0,0,0,0,0
10DMFA,Barton-Le-Clay                  ,2776,1857,11,91,919
10DMFB,Beaudesert                      ,4317,2759,13,167,1558
10DMFC,Brooklands                      ,6535,4830,27,298,1705
10DMFD,Caddington                      ,3029,1966,7,129,1063
10DMFE,Dunstable Central               ,5971,3736,19,271,2235
10DMFF,Eaton Bray                      ,1915,1230,5,75,685
10DMFG,Heath And Reach                 ,1054,666,1,36,388
10DMFH,Hockliffe                       ,1163,768,2,54,395
10DMFJ,Houghton Central                ,4143,2635,23,274,1508
10DMFK,Houghton East                   ,4391,3241,20,286,1150
10DMFL,Houghton South                  ,3576,2629,18,182,947
10DMFM,Icknield                        ,5150,3607,18,195,1543
10DMFN,Kensworth                       ,1238,808,5,49,430
10DMFP,Linslade                        ,4268,2964,10,151,1304
10DMFQ,Northfields                     ,5437,3483,31,262,1954
10DMFR,Plantation                      ,5023,3213,18,225,1810
10DMFS,Priory                          ,4448,2825,29,253,1623
10DMFT,Slip End                        ,1903,1343,6,70,560
10DMFU,Southcott                       ,4618,3507,7,145,1111
10DMFW,Stanbridge                      ,1228,842,0,33,386
10DMFX,Streatley                       ,1345,909,0,43,436
10DMFY,Studham                         ,1400,883,3,28,517
10DMFZ,Toddington                      ,3236,2137,11,112,1099
10DMGA,Totternhoe                      ,1100,663,4,44,437
10DMGB,Watling                         ,5690,4270,20,147,1420
10DMSS,Shipping                        ,0,0,0,0,0
11DNFA,Ascot                           ,8417,6198,14,234,2219
11DNFB,Binfield                        ,4204,2935,10,94,1269
11DNFC,Bullbrook                       ,5539,3664,25,265,1875
11DNFD,College Town                    ,3989,3058,19,140,931
11DNFE,Cranbourne                      ,1169,754,1,41,415
11DNFF,Crowthorne                      ,4555,2797,9,103,1758
11DNFG,Garth                           ,3136,1942,19,134,1194
11DNFH,Great Hollands North            ,3834,2894,18,191,940
11DNFJ,Great Hollands South            ,3745,2904,22,221,841
11DNFK,Hanworth                        ,6331,4834,19,296,1497
11DNFL,Harmanswater                    ,6909,4770,46,305,2139
11DNFM,Little Sandhurst                ,3196,2264,13,90,932
11DNFN,Old Bracknell                   ,4321,3007,15,188,1314
11DNFP,Owlsmoor                        ,4073,3293,7,147,780
11DNFQ,Priestwood                      ,2887,1805,20,135,1082
11DNFR,St.Mary's                       ,1405,911,2,53,494
11DNFS,Central Sandhurst               ,3192,2212,11,103,980
11DNFT,Warfield                        ,1502,926,3,44,576
11DNFU,Wildridings                     ,2406,1612,9,102,794
11DNSS,Shipping                        ,0,0,0,0,0
11DPFA,Aldermaston                     ,0,0,0,0,0
11DPFB,Basildon                        ,2000,1217,9,63,783
11DPFC,Beenham                         ,2660,1779,13,103,881
11DPFD,Bradfield                       ,1908,1227,4,40,681
11DPFE,Bucklebury                      ,1630,990,1,49,640
11DPFF,Burghfield                      ,5473,3859,24,162,1614
11DPFG,Calcot                          ,2502,1670,5,106,832
11DPFH,Chieveley                       ,2521,1693,8,74,828
11DPFJ,Cold Ash                        ,3016,1951,5,83,1065
11DPFK,Compton                         ,2603,1682,6,72,921
11DPFL,Craven                          ,4570,2921,10,175,1649
11DPFM,Downlands                       ,1872,1217,5,41,655
11DPFN,Falkland                        ,4656,3069,7,120,1587
11DPFP,Greenham                        ,2020,1575,54,44,445
11DPFQ,Hungerford                      ,5048,3375,7,144,1673
11DPFR,Kintbury                        ,2566,1703,6,80,863
11DPFS,Lambourn Valley                 ,4191,2859,14,116,1332
11DPFT,Mortimer                        ,3988,2519,6,136,1469
11DPFU,Northcroft                      ,2036,1227,6,61,809
11DPFW,Pangbourne                      ,2741,1762,7,74,979
11DPFX,Purley                          ,3131,2252,3,113,879
11DPFY,St.John's                       ,5595,3642,25,241,1953
11DPFZ,Shaw-cum-Donnington             ,1315,811,1,38,504
11DPGA,Speen                           ,2655,1725,3,89,930
11DPGB,Thatcham North                  ,3333,2339,13,140,994
11DPGC,Thatcham South                  ,7495,5508,35,207,1987
11DPGD,Thatcham West                   ,4533,3416,12,173,1117
11DPGE,Theale                          ,7588,5851,14,217,1737
11DPGF,Tilehurst                       ,8428,6477,18,203,1951
11DPGG,Turnpike                        ,2464,1769,13,119,695
11DPGH,Winchcombe                      ,3203,2130,14,141,1073
11DPSS,Shipping                        ,0,0,0,0,0
11DQFA,Abbey                           ,8059,5756,48,652,2303
11DQFB,Battle                          ,6839,4919,33,419,1920
11DQFC,Caversham                       ,7927,5396,27,311,2531
11DQFD,Church                          ,5936,3661,22,379,2275
11DQFE,Katesgrove                      ,6198,4310,29,407,1888
11DQFF,Kentwood                        ,6856,4773,20,312,2083
11DQFG,Minster                         ,7049,4533,25,373,2516
11DQFH,Norcot                          ,7165,4887,36,395,2278
11DQFJ,Park                            ,6448,4338,36,370,2110
11DQFK,Peppard                         ,7674,5159,27,205,2515
11DQFL,Redlands                        ,6397,4089,32,337,2308
11DQFM,Southcote                       ,6598,3876,17,262,2722
11DQFN,Thames                          ,6677,4168,16,159,2509
11DQFP,Tilehurst                       ,6568,4283,12,196,2285
11DQFQ,Whitley                         ,6903,4359,33,498,2544
11DQSS,Shipping                        ,0,0,0,0,0
11DRFA,Baylis                          ,5572,3832,46,501,1740
11DRFB,Britwell                        ,6592,3813,33,366,2779
11DRFC,Central                         ,5987,3951,40,434,2036
11DRFD,Chalvey                         ,8311,5547,48,629,2764
11DRFE,Cippenham                       ,7734,5527,38,323,2207
11DRFF,Farnham                         ,5525,3950,36,382,1575
11DRFG,Foxborough                      ,5504,3953,19,374,1551
11DRFH,Haymill                         ,6393,4410,25,363,1983
11DRFJ,Kedermister                     ,5045,2907,14,268,2138
11DRFK,Langley St.Mary's               ,5283,3786,26,205,1497
11DRFL,Stoke                           ,4861,3053,39,400,1808
11DRFM,Upton                           ,5172,3546,28,234,1626
11DRFN,Wexham Lea                      ,6184,4030,46,345,2154
11DRSS,Shipping                        ,0,0,0,0,0
11DSFA,Belmont                         ,5683,3731,17,227,1952
11DSFB,Bisham and Cookham              ,5725,3580,11,179,2145
11DSFC,Boyn Hill                       ,5297,3724,14,235,1573
11DSFD,Bray                            ,6394,4459,27,187,1935
11DSFE,Castle                          ,3602,2482,10,133,1120
11DSFF,Clewer North                    ,5138,3415,19,204,1723
11DSFG,Clewer South                    ,4013,2704,7,149,1309
11DSFH,Cox Green                       ,5868,4362,9,150,1506
11DSFJ,Datchet                         ,3929,2624,25,165,1305
11DSFK,Eton North and South            ,1130,843,1,25,287
11DSFL,Eton West                       ,1912,1272,2,61,640
11DSFM,Furze Platt                     ,5585,3853,11,181,1732
11DSFN,Horton and Wraysbury            ,3683,2422,9,120,1261
11DSFP,Hurley                          ,4929,3204,12,162,1725
11DSFQ,Oldfield                        ,6259,4004,25,239,2255
11DSFR,Old Windsor                     ,4185,2647,3,129,1538
11DSFS,Park                            ,5316,3587,11,170,1729
11DSFT,Pinkneys Green                  ,5540,3507,11,197,2033
11DSFU,St. Mary's                      ,6118,3936,11,239,2182
11DSFW,Sunningdale and South Ascot     ,6530,3908,9,195,2622
11DSFX,Sunninghill                     ,6071,3967,17,156,2104
11DSFY,Trinity                         ,4833,3111,22,175,1722
11DSSS,Shipping                        ,0,0,0,0,0
11DTFA,Arborfield                      ,1622,1190,10,53,432
11DTFB,Barkham                         ,2335,1848,42,63,487
11DTFC,Bulmershe                       ,3359,2210,11,126,1149
11DTFD,Charvil                         ,1676,1164,5,61,512
11DTFE,Coronation                      ,5583,4000,20,136,1583
11DTFF,Emmbrook                        ,4795,3335,17,147,1460
11DTFG,Evendons                        ,8567,6368,36,241,2199
11DTFH,Finchampstead North             ,4325,3161,11,129,1164
11DTFJ,Finchampstead South             ,4755,3231,15,157,1524
11DTFK,Hurst                           ,1363,893,4,33,470
11DTFL,Little Hungerford               ,8095,5994,12,216,2101
11DTFM,Loddon                          ,6519,4988,9,236,1531
11DTFN,Norreys                         ,5967,3991,14,198,1976
11DTFP,Redhatch                        ,11213,8421,44,257,2792
11DTFQ,Remenham and Wargrave           ,3673,2219,6,87,1454
11DTFR,Shinfield                       ,5720,3839,15,235,1881
11DTFS,Sonning                         ,1157,695,3,26,462
11DTFT,South Lake                      ,4404,3389,12,132,1015
11DTFU,Swallowfield                    ,1409,915,3,36,494
11DTFW,Twyford and Ruscombe            ,5265,3534,13,153,1731
11DTFX,Wescott                         ,3954,2527,23,132,1427
11DTFY,Whitegates                      ,2875,1774,7,101,1101
11DTFZ,Winnersh                        ,5729,4093,28,194,1636
11DTGA,Wokingham Without               ,5219,3561,14,156,1658
11DTSS,Shipping                        ,0,0,0,0,0
12DUFA,Aston Clinton                   ,3167,2141,5,97,1026
12DUFB,Aylesbury Central               ,1842,1143,5,133,699
12DUFC,Bedgrove                        ,5390,3743,8,137,1647
12DUFD,Bierton                         ,2138,1438,6,63,700
12DUFE,Brill                           ,1355,894,4,34,461
12DUFF,Buckingham North                ,3330,2065,9,93,1265
12DUFG,Buckingham South                ,5029,3480,15,175,1549
12DUFH,Cheddington                     ,2138,1469,6,70,669
12DUFJ,Edlesborough                    ,2452,1684,9,76,768
12DUFK,Elmhurst                        ,4368,3012,18,280,1356
12DUFL,Gatehouse                       ,2694,1756,12,194,938
12DUFM,Grange                          ,4191,3049,18,143,1142
12DUFN,Great Brickhill                 ,1657,1048,4,70,609
12DUFP,Great Horwood                   ,1837,1239,6,51,598
12DUFQ,Grendon Underwood               ,2059,1394,12,58,665
12DUFR,Haddenham                       ,3817,2500,7,122,1317
12DUFS,Hogshaw                         ,1532,988,0,32,544
12DUFT,Long Crendon                    ,2037,1303,8,76,734
12DUFU,Luffield Abbey                  ,1514,1048,8,44,466
12DUFW,Mandeville                      ,5952,4196,21,349,1756
12DUFX,Marsh Gibbon                    ,1866,1232,7,56,634
12DUFY,Meadowcroft                     ,5440,4071,19,392,1369
12DUFZ,Newton Longville                ,1554,1051,6,61,503
12DUGA,Oakfield                        ,4135,2899,16,165,1236
12DUGB,Oakley                          ,1966,1317,4,64,649
12DUGC,Pitstone                        ,2202,1478,8,84,724
12DUGD,Quainton                        ,1970,1282,7,56,688
12DUGE,Southcourt                      ,6108,4387,38,487,1721
12DUGF,Steeple Claydon                 ,2248,1552,3,78,696
12DUGG,Stewkley                        ,2165,1372,9,72,793
12DUGH,Stone                           ,3150,2018,15,92,1132
12DUGJ,Tingewick                       ,1549,992,8,48,557
12DUGK,Waddesdon                       ,1730,1160,4,63,570
12DUGL,Wendover                        ,7086,4886,51,172,2200
12DUGM,Weston Turville                 ,6067,4368,7,208,1699
12DUGN,Wing                            ,2187,1515,4,73,672
12DUGP,Wingrave                        ,1590,1064,4,46,526
12DUGQ,Winslow                         ,3482,2234,6,92,1248
12DUSS,Shipping                        ,0,0,0,0,0
12DWFA,Amersham Common                 ,2789,1881,5,94,908
12DWFB,Amersham-on-the-Hill            ,4030,2332,9,148,1698
12DWFC,Amersham Town                   ,3315,2142,21,73,1173
12DWFD,Asheridge Vale                  ,1447,930,6,54,517
12DWFE,Ashley Green and Latimer        ,1569,1065,2,60,504
12DWFF,Austenwood                      ,1777,1046,4,41,731
12DWFG,Ballinger and South Heath       ,970,633,0,25,337
12DWFH,Chalfont Common                 ,3221,1950,10,78,1271
12DWFJ,Chalfont St.Giles               ,4966,3081,9,132,1885
12DWFK,Chalfont St.Peter Central       ,3186,1987,4,101,1199
12DWFL,Chartridge                      ,1376,940,2,39,436
12DWFM,Chenies                         ,0,0,0,0,0
12DWFN,Chesham Bois and Weedon Hill    ,3378,2014,7,93,1364
12DWFP,Cholesbury and The Lee          ,1322,785,4,33,537
12DWFQ,Coleshill and Penn Street       ,1131,680,2,32,451
12DWFR,Gold Hill                       ,2023,1258,5,61,765
12DWFS,Great Missenden                 ,2029,1148,9,47,881
12DWFT,Hilltop                         ,1437,959,6,34,478
12DWFU,Holmer Green                    ,3380,2226,6,99,1154
12DWFW,Little Chalfont                 ,3277,1933,7,102,1344
12DWFX,Little Missenden                ,2003,1302,10,68,701
12DWFY,Lowndes                         ,1539,1001,7,52,538
12DWFZ,Newtown                         ,3025,2142,12,98,883
12DWGA,Penn                            ,2574,1575,3,74,999
12DWGB,Pond Park                       ,2509,1704,13,113,805
12DWGC,Prestwood and Heath End         ,5089,3450,12,130,1639
12DWGD,St.Mary's                       ,1049,591,1,23,458
12DWGE,Seer Green and Jordans          ,2346,1409,1,56,937
12DWGF,Townsend                        ,2720,1809,8,121,911
12DWGG,Waterside                       ,2599,1830,8,93,769
12DWSS,Shipping                        ,0,0,0,0,0
12DXFA,Bradwell                        ,12902,9140,90,696,3762
12DXFB,Church Green                    ,1196,778,1,37,418
12DXFC,Danesborough                    ,1715,1218,4,60,497
12DXFD,Denbigh                         ,6211,4548,36,396,1663
12DXFE,Eaton                           ,4167,2658,45,502,1509
12DXFF,Fenny Stratford                 ,8373,5109,71,661,3264
12DXFG,Lavendon                        ,1664,1098,6,50,566
12DXFH,Linford                         ,13832,9931,88,769,3901
12DXFJ,Loughton                        ,11211,8786,37,532,2425
12DXFK,Manor Farm                      ,3003,1927,12,119,1076
12DXFL,Newport Pagnell                 ,10764,7757,43,392,3007
12DXFM,Newton                          ,3993,2799,14,177,1194
12DXFN,Olney                           ,4717,3183,8,136,1534
12DXFP,Pineham                         ,9466,7137,53,568,2329
12DXFQ,Sherington                      ,1945,1312,9,61,633
12DXFR,Stantonbury                     ,5329,3753,42,220,1576
12DXFS,Stony Stratford                 ,6261,4167,40,326,2094
12DXFT,Whaddon                         ,5420,3755,20,254,1665
12DXFU,Woburn Sands                    ,1738,1121,6,33,617
12DXFW,Wolverton                       ,6196,4104,43,386,2092
12DXFX,Wolverton Stacey Bushes         ,4904,3624,42,309,1280
12DXFY,Woughton                        ,7056,4980,50,460,2076
12DXSS,Shipping                        ,0,0,0,0,0
12DYFA,Beaconsfield North              ,3444,1911,6,92,1533
12DYFB,Beaconsfield South              ,2626,1667,17,97,959
12DYFC,Beaconsfield West               ,2539,1577,7,86,962
12DYFD,Burnham Beeches                 ,2364,1476,2,57,888
12DYFE,Burnham Church                  ,2539,1613,7,93,926
12DYFF,Burnham Lent Rise               ,4232,2932,16,166,1300
12DYFG,Denham North                    ,2865,1642,6,94,1223
12DYFH,Denham South                    ,2735,1872,2,97,863
12DYFJ,Dorney                          ,0,0,0,0,0
12DYFK,Farnham Royal                   ,4291,2628,6,123,1663
12DYFL,Gerrards Cross North            ,2366,1273,4,62,1093
12DYFM,Gerrards Cross South            ,3556,2048,7,94,1508
12DYFN,Hedgerley and Fulmer            ,1110,700,1,26,410
12DYFP,Iver Colnbrook                  ,1127,794,7,75,333
12DYFQ,Iver Heath                      ,3330,2160,3,115,1170
12DYFR,Iver Richings Park              ,1468,991,6,30,477
12DYFS,Iver Village                    ,2860,1864,8,150,996
12DYFT,Stoke Poges                     ,3762,2352,11,121,1410
12DYFU,Taplow                          ,2049,1381,0,54,668
12DYFW,Wexham                          ,1844,1238,7,75,606
12DYSS,Shipping                        ,0,0,0,0,0
12DZFA,Bledlow-cum-Saunderton          ,2389,1516,1,74,873
12DZFB,Booker and Castlefield          ,6644,4169,36,430,2475
12DZFC,Bourne End-cum-Hedsor           ,4571,2953,16,131,1618
12DZFD,Bowerdean and Daws Hill         ,6126,4165,22,368,1961
12DZFE,Cressex and Frogmoor            ,6113,4289,25,306,1824
12DZFF,Downley                         ,1715,1217,6,45,498
12DZFG,Flackwell Heath                 ,4957,3296,13,148,1661
12DZFH,Great Marlow                    ,1245,867,7,21,378
12DZFJ,Green Hill and Totteridge       ,6080,4331,22,271,1749
12DZFK,Hambleden Valley                ,1918,1184,4,41,734
12DZFL,Hazlemere Central               ,2314,1535,3,58,779
12DZFM,Hazlemere East                  ,2403,1670,9,52,733
12DZFN,Hazlemere West                  ,2480,1875,15,58,605
12DZFP,Hughenden Valley                ,1615,1092,2,48,523
12DZFQ,Icknield                        ,2365,1497,5,80,868
12DZFR,Keep Hill and Hicks Farm        ,5593,3602,33,285,1991
12DZFS,Kingshill                       ,2888,2078,10,73,810
12DZFT,Lacy Green and Hampden          ,2078,1394,9,64,684
12DZFU,Lane End and Piddington         ,3317,2271,12,154,1046
12DZFW,Little Marlow                   ,1143,732,2,26,411
12DZFX,Loudwater                       ,3233,2489,13,147,744
12DZFY,Marlow Bottom                   ,2661,1902,8,87,759
12DZFZ,Marlow North                    ,6279,3998,16,213,2281
12DZGA,Marlow South                    ,4978,3283,9,193,1695
12DZGB,Marsh and Micklefield           ,5746,3961,18,356,1785
12DZGC,Naphill-cum-Bradenham           ,3064,2199,13,83,865
12DZGD,Oakridge and Tinkers Wood       ,7315,5185,50,582,2130
12DZGE,Princes Risborough              ,6562,3818,13,204,2744
12DZGF,Stokenchurch                    ,3885,2694,13,144,1191
12DZGG,The Wooburns                    ,3766,2661,8,159,1105
12DZGH,Tylers Green                    ,3489,2348,5,84,1141
12DZGJ,West Wycombe and Sands          ,5856,4267,14,216,1589
12DZSS,Shipping                        ,0,0,0,0,0
13EBFA,Abbey                           ,5160,3172,18,271,1988
13EBFB,Arbury                          ,5596,3414,23,303,2182
13EBFC,Castle                          ,5249,3123,15,198,2126
13EBFD,Cherry Hinton                   ,5642,3672,11,140,1970
13EBFE,Coleridge                       ,6012,3440,29,191,2572
13EBFF,East Chesterton                 ,6874,4504,21,341,2370
13EBFG,King's Hedges                   ,5446,3877,24,354,1569
13EBFH,Market                          ,3096,1764,10,142,1332
13EBFJ,Newnham                         ,3705,1700,11,79,2005
13EBFK,Petersfield                     ,6080,4110,33,325,1970
13EBFL,Queen Edith's                   ,6136,3561,17,177,2575
13EBFM,Romsey                          ,5803,3974,27,332,1829
13EBFN,Trumpington                     ,5673,3364,25,173,2309
13EBFP,West Chesterton                 ,5825,3741,23,276,2084
13EBSS,Shipping                        ,0,0,0,0,0
13ECFA,Bottisham                       ,2100,1375,3,51,725
13ECFB,Burwell                         ,3689,2361,12,99,1328
13ECFC,Cheveley                        ,1816,1125,6,35,691
13ECFD,Downham                         ,2328,1482,13,66,846
13ECFE,Dullingham Villages             ,1627,1041,4,41,586
13ECFF,Ely Northern                    ,3183,2104,12,126,1079
13ECFG,Ely Southern                    ,2176,1296,10,69,880
13ECFH,Ely West                        ,4044,2438,19,107,1606
13ECFJ,Fordham Villages                ,2524,1625,8,87,899
13ECFK,Haddenham                       ,2991,1915,10,98,1076
13ECFL,Isleham                         ,1528,958,7,35,570
13ECFM,Littleport                      ,5155,3205,29,219,1950
13ECFN,Soham                           ,6656,4348,28,231,2308
13ECFP,Stretham                        ,1552,1010,8,49,542
13ECFQ,Sutton                          ,2895,1933,16,83,962
13ECFR,The Swaffhams                   ,1442,911,1,32,531
13ECFS,Witchford                       ,1256,804,5,49,452
13ECFT,Woodditton                      ,1641,1106,4,39,535
13ECSS,Shipping                        ,0,0,0,0,0
13EEFA,Benwick and Doddington          ,1853,1125,6,71,728
13EEFB,Chatteris East                  ,2097,1283,8,78,814
13EEFC,Chatteris North                 ,1202,707,4,55,495
13EEFD,Chatteris South                 ,1067,662,2,48,405
13EEFE,Chatteris West                  ,1480,958,4,52,522
13EEFF,Elm                             ,2641,1576,16,171,1065
13EEFG,Leverington                     ,3150,1834,26,141,1316
13EEFH,Manea                           ,1569,922,16,70,647
13EEFJ,March East                      ,5087,2810,29,228,2277
13EEFK,March North                     ,4533,2688,15,238,1845
13EEFL,March West                      ,4133,2358,23,156,1775
13EEFM,Newton and Tydd St.Giles        ,1273,788,13,58,485
13EEFN,Outwell and Upwell              ,0,0,0,0,0
13EEFP,Parson Drove and Wisbech St.Mary,2933,1698,21,204,1235
13EEFQ,Whittlesey Bassenhally          ,2405,1553,8,82,852
13EEFR,Whittlesey Central              ,1309,802,1,46,507
13EEFS,Whittlesey East                 ,1904,1145,10,66,759
13EEFT,Whittlesey Kingsmoor            ,1294,772,13,90,522
13EEFU,Whittlesey South                ,2247,1550,14,107,697
13EEFW,Whittlesey West                 ,1874,1238,12,67,636
13EEFX,Wimblington                     ,1229,665,9,54,564
13EEFY,Wisbech East                    ,3405,1873,22,166,1532
13EEFZ,Wisbech North                   ,4274,2679,37,371,1595
13EEGA,Wisbech North East              ,2417,1472,19,105,945
13EEGB,Wisbech South West              ,4736,2651,35,264,2085
13EESS,Shipping                        ,0,0,0,0,0
13EFFA,Brampton                        ,3684,2518,19,94,1166
13EFFB,Buckden                         ,2084,1319,9,47,765
13EFFC,Bury                            ,1726,1177,18,64,549
13EFFD,Earith                          ,3045,2134,11,93,911
13EFFE,Eaton Ford                      ,4052,2951,9,134,1101
13EFFF,Eaton Socon                     ,5324,3672,27,261,1652
13EFFG,Ellington                       ,1738,1132,14,46,606
13EFFH,Elton                           ,1414,890,2,43,524
13EFFJ,Eynesbury                       ,6479,4522,38,388,1957
13EFFK,Farcet                          ,995,630,3,56,365
13EFFL,Fenstanton                      ,2074,1459,7,49,615
13EFFM,Godmanchester                   ,4215,2844,17,146,1371
13EFFN,Gransden                        ,1885,1331,6,75,554
13EFFP,Hemingford Abbots and Hilton    ,1241,780,4,30,461
13EFFQ,Hemingford Grey                 ,2012,1231,3,41,781
13EFFR,Houghton And Wyton              ,2740,2028,37,90,712
13EFFS,Huntingdon North                ,6240,4218,44,337,2022
13EFFT,Huntingdon West                 ,5788,3984,34,303,1804
13EFFU,Kimbolton                       ,1645,1043,10,39,602
13EFFW,Needingworth                    ,1910,1340,7,60,570
13EFFX,Paxton                          ,2861,2014,15,115,847
13EFFY,Priory Park                     ,3671,2300,12,144,1371
13EFFZ,Ramsey                          ,5575,3522,23,243,2053
13EFGA,St.Ives North                   ,6995,5369,30,266,1626
13EFGB,St.Ives South                   ,4939,3099,7,170,1840
13EFGC,Sawtry                          ,4373,3011,39,183,1362
13EFGD,Somersham                       ,2716,1898,9,90,818
13EFGE,Staughton                       ,2389,1429,17,56,960
13EFGF,Stilton                         ,2900,2053,22,94,847
13EFGG,The Offords                     ,1862,1273,5,56,589
13EFGH,The Stukeleys                   ,3455,2476,140,82,979
13EFGJ,Upwood and The Raveleys         ,1493,1013,39,42,480
13EFGK,Warboys                         ,3301,2165,13,94,1136
13EFGL,Yaxley                          ,5314,3791,54,187,1523
13EFSS,Shipping                        ,0,0,0,0,0
13EGFA,Barnack                         ,2082,1237,5,53,845
13EGFB,Bretton                         ,5722,4107,27,470,1615
13EGFC,Central                         ,5265,2781,55,763,2484
13EGFD,Dogsthorpe                      ,6461,3708,62,559,2753
13EGFE,East                            ,6660,3958,61,651,2702
13EGFF,Eye                             ,2310,1432,4,98,878
13EGFG,Fletton                         ,7359,4924,34,576,2435
13EGFH,Glinton                         ,2515,1653,7,87,862
13EGFJ,Newborough                      ,1504,1016,9,56,488
13EGFK,North                           ,4935,2737,36,357,2198
13EGFL,Northborough                    ,2157,1393,13,80,764
13EGFM,Orton Longueville               ,7930,5342,49,503,2588
13EGFN,Orton Waterville                ,7260,4903,37,414,2357
13EGFP,Park                            ,6794,4158,38,380,2636
13EGFQ,Paston                          ,4867,3214,40,358,1653
13EGFR,Ravensthorpe                    ,6034,3851,62,522,2183
13EGFS,Stanground                      ,6957,4339,38,366,2618
13EGFT,Thorney                         ,1764,1183,6,84,581
13EGFU,Walton                          ,5629,3604,28,344,2025
13EGFW,Werrington                      ,11404,8058,55,480,3346
13EGFX,West                            ,10499,6781,45,432,3718
13EGFY,Wittering                       ,2386,1761,39,91,625
13EGSS,Shipping                        ,0,0,0,0,0
13EHFA,Abington                        ,1557,1027,6,50,530
13EHFB,Arrington                       ,1114,713,1,46,401
13EHFC,Balsham                         ,1943,1257,3,51,686
13EHFD,Bar Hill                        ,4418,3383,7,103,1035
13EHFE,Barrington and Shepreth         ,1360,922,2,56,438
13EHFF,Barton                          ,1183,704,1,20,479
13EHFG,Bassingbourn                    ,3313,2346,16,152,967
13EHFH,Bourn                           ,1422,907,4,39,515
13EHFJ,Castle Camps                    ,1384,870,6,51,514
13EHFK,Comberton                       ,1842,1317,12,56,525
13EHFL,Coton                           ,1237,771,5,35,466
13EHFM,Cottenham                       ,3897,2502,13,95,1395
13EHFN,Duxford                         ,1447,987,4,46,460
13EHFP,Elsworth                        ,1580,1083,2,41,497
13EHFQ,Foxton                          ,1802,1200,5,39,602
13EHFR,Fulbourn                        ,3917,2637,21,80,1280
13EHFS,Gomlingay                       ,2626,1737,8,80,889
13EHFT,Girton                          ,2621,1537,4,49,1084
13EHFU,Great Shelford                  ,3260,1865,4,78,1395
13EHFW,Hardwick                        ,2717,1996,9,47,721
13EHFX,Harston                         ,1582,993,3,35,589
13EHFY,Haslingfield                    ,1320,850,2,40,470
13EHFZ,Histon                          ,5738,3777,14,112,1961
13EHGA,Ickleton                        ,1407,915,7,38,492
13EHGB,Linton                          ,3250,2089,14,78,1161
13EHGC,Little Shelford                 ,1201,762,2,31,439
13EHGD,Longstanton                     ,1584,1158,10,55,426
13EHGE,Melbourn                        ,3167,2107,1,93,1060
13EHGF,Meldreth                        ,1753,1137,5,74,616
13EHGG,Milton                          ,3188,2453,12,104,735
13EHGH,Orwell                          ,1696,1119,3,44,577
13EHGJ,Over                            ,1855,1317,5,48,538
13EHGK,Papworth                        ,1299,877,0,43,422
13EHGL,Sawston                         ,5565,3782,18,122,1783
13EHGM,Stapleford                      ,1404,845,1,14,559
13EHGN,Swavesey                        ,1491,1033,7,32,458
13EHGP,Teversham                       ,2772,2059,7,88,713
13EHGQ,The Mordens                     ,1759,1150,2,57,609
13EHGR,The Wilbrahams                  ,1223,786,5,36,437
13EHGS,Waterbeach                      ,3847,2742,14,93,1105
13EHGT,Whittlesford                    ,1707,1124,4,46,583
13EHGU,Willingham                      ,2559,1749,5,70,810
13EHSS,Shipping                        ,0,0,0,0,0
14EJFA,Barrow                          ,3803,2246,15,89,1557
14EJFB,Blacon Hall                     ,4581,2781,64,480,1800
14EJFC,Boughton                        ,2700,1596,21,133,1104
14EJFD,Boughton Heath                  ,4645,2951,24,128,1694
14EJFE,Christleton                     ,3742,2143,13,102,1599
14EJFF,College                         ,4557,2415,45,361,2142
14EJFG,Curzon                          ,3084,1754,19,174,1330
14EJFH,Dee Point                       ,4780,2979,72,419,1801
14EJFJ,Dodleston                       ,1669,1068,5,37,601
14EJFK,Elton                           ,4668,3137,33,161,1531
14EJFL,Farndon                         ,1715,978,12,48,737
14EJFM,Grosvenor                       ,4436,2352,29,187,2084
14EJFN,Hoole                           ,4527,2685,30,260,1842
14EJFP,Malpas                          ,2967,1775,27,60,1192
14EJFQ,Mollington                      ,2082,1286,17,64,796
14EJFR,Newton                          ,4157,2477,23,142,1680
14EJFS,Plas Newton                     ,3752,1983,18,160,1769
14EJFT,Saughall                        ,2988,1870,21,90,1118
14EJFU,Sealand                         ,3782,2340,29,237,1442
14EJFW,Tarvin                          ,3369,2093,15,83,1276
14EJFX,Tattenhall                      ,2669,1647,10,72,1022
14EJFY,Tilston                         ,1350,842,9,40,508
14EJFZ,Upton Grange                    ,3119,1765,16,85,1354
14EJGA,Upton Heath                     ,4194,2309,24,155,1885
14EJGB,Vicars Cross                    ,4259,2649,42,142,1610
14EJGC,Waverton                        ,1470,912,8,49,558
14EJGD,Westminster                     ,4834,2804,47,305,2030
14EJSS,SHIPPING                        ,0,0,0,0,0
14EKFA,Alsager East                    ,4029,2247,24,157,1782
14EKFB,Alsager West                    ,5518,3381,32,136,2137
14EKFC,Astbury                         ,1148,703,8,22,445
14EKFD,Brereton                        ,1305,835,12,40,470
14EKFE,Buglawton                       ,2974,1983,17,145,991
14EKFF,Congleton Central               ,2654,1595,13,91,1059
14EKFG,Congleton North                 ,4253,2564,34,273,1689
14EKFH,Congleton South                 ,4710,3064,19,121,1646
14EKFJ,Congleton West                  ,5611,3694,35,179,1917
14EKFK,Dane                            ,3648,2121,10,65,1527
14EKFL,Holmes Chapel                   ,4271,2803,15,110,1468
14EKFM,Lawton                          ,2734,1742,18,90,992
14EKFN,Middlewich Cledford             ,2844,1896,22,135,948
14EKFP,Middlewich Kinderton            ,5020,3377,36,173,1643
14EKFQ,Odd Rode                        ,4274,2778,32,167,1496
14EKFR,Sandbach East                   ,4090,2506,36,162,1584
14EKFS,Sandbach North                  ,4844,3052,23,149,1792
14EKFT,Sandbach West                   ,3786,2472,32,118,1314
14EKSS,Shipping                        ,0,0,0,0,0
14ELFA,Acton                           ,1187,695,3,21,492
14ELFB,Alexandra                       ,3942,2361,56,260,1581
14ELFC,Audlem                          ,1899,1062,7,59,837
14ELFD,Barony Weaver                   ,3898,2149,28,163,1749
14ELFE,Bunbury                         ,1625,1001,3,37,624
14ELFF,Combermere                      ,1500,962,10,44,538
14ELFG,Coppenhall                      ,5414,3330,56,396,2084
14ELFH,Delamere                        ,3011,1944,25,198,1067
14ELFJ,Grosvenor                       ,3852,2226,51,298,1626
14ELFK,Haslington                      ,4817,3233,37,149,1584
14ELFL,Maw Green                       ,4161,2194,50,308,1967
14ELFM,Minshull                        ,3024,2316,28,99,708
14ELFN,Peckforton                      ,1275,776,8,38,499
14ELFP,Queens Park                     ,4220,2476,33,215,1744
14ELFQ,Ruskin Park                     ,3944,2352,37,257,1592
14ELFR,St. Barnabas                    ,3893,2271,47,281,1622
14ELFS,St. Johns                       ,3447,2244,39,236,1203
14ELFT,Shavington                      ,5394,3642,33,148,1752
14ELFU,Waldron                         ,4638,3052,26,143,1586
14ELFW,Wellington                      ,3115,1759,12,89,1356
14ELFX,Weston Park                     ,1455,928,6,32,527
14ELFY,Willaston East                  ,2173,1284,9,53,889
14ELFZ,Willaston West                  ,2741,1555,12,67,1186
14ELGA,Wistaston                       ,3813,2315,19,87,1498
14ELGB,Wrenbury                        ,1570,959,12,35,611
14ELGC,Wybunbury                       ,2624,1614,15,65,1010
14ELSS,Shipping                        ,0,0,0,0,0
14EMFA,Burton and Ness                 ,2340,1529,16,65,811
14EMFB,Central                         ,3759,2215,67,283,1544
14EMFC,Grange                          ,3863,2060,84,343,1803
14EMFD,Groves                          ,5876,4368,44,202,1508
14EMFE,Ledsham                         ,5072,3490,40,177,1582
14EMFF,Little Neston                   ,2780,1552,17,112,1228
14EMFG,Neston                          ,3175,1817,30,219,1358
14EMFH,Parkgate                        ,3110,1695,10,92,1415
14EMFJ,Pooltown                        ,2836,1686,30,191,1150
14EMFK,Rivacre                         ,3584,2023,40,268,1561
14EMFL,Riverside                       ,1826,1271,21,68,555
14EMFM,Rossmore                        ,4703,2783,46,246,1920
14EMFN,Stanlow                         ,2802,1700,61,282,1102
14EMFP,Sutton                          ,5149,3574,40,232,1575
14EMFQ,Westminster                     ,2917,1730,55,297,1187
14EMFR,Whitby                          ,4290,2803,53,193,1487
14EMFS,Willaston and Thornton          ,3211,1855,21,94,1356
14EMFT,Wolverham                       ,2271,1153,38,181,1118
14EMSS,Shipping                        ,0,0,0,0,0
14ENFA,Appleton                        ,5217,3008,41,345,2209
14ENFB,Broadheath                      ,5000,3055,45,339,1945
14ENFC,Brookfields                     ,5714,3552,74,498,2162
14ENFD,Castlefields                    ,5813,3251,100,690,2562
14ENFE,Clough                          ,4542,3232,47,282,1310
14ENFF,Daresbury                       ,1323,735,7,36,588
14ENFG,Ditton                          ,4831,2714,41,361,2117
14ENFH,Farnworth                       ,6452,4116,45,237,2336
14ENFJ,Grange                          ,5536,2977,79,457,2559
14ENFK,Hale                            ,1619,1069,16,80,550
14ENFL,Halton                          ,5177,3082,38,302,2095
14ENFM,Halton Brook                    ,5981,3568,68,544,2413
14ENFN,Heath                           ,5217,3065,39,187,2152
14ENFP,Hough Green                     ,6150,3773,50,470,2377
14ENFQ,Kingsway                        ,4992,2688,64,520,2304
14ENFR,Mersey                          ,5349,3077,83,378,2272
14ENFS,Murdishaw                       ,4503,2722,82,472,1781
14ENFT,Norton                          ,5173,3159,81,541,2014
14ENFU,Riverside                       ,5416,3153,60,509,2263
14ENSS,Shipping                        ,0,0,0,0,0
14EPFA,Alderley Edge                   ,3817,2064,8,92,1753
14EPFB,Bollington Central              ,1576,1094,8,27,482
14EPFC,Bollington East                 ,2132,1400,14,56,732
14EPFD,Bollington West                 ,2036,1312,9,65,724
14EPFE,Dean Row                        ,4039,2713,16,223,1326
14EPFF,Disley                          ,3746,2427,14,119,1319
14EPFG,Fulshaw                         ,4109,2547,9,91,1562
14EPFH,Gawsworth                       ,2004,1265,12,37,739
14EPFJ,Handforth                       ,5303,3019,22,220,2284
14EPFK,Henbury                         ,1759,1163,5,44,596
14EPFL,High Legh                       ,2201,1483,5,45,718
14EPFM,Hough                           ,2898,1516,9,81,1382
14EPFN,Knutsford Nether                ,1944,1078,10,51,866
14EPFP,Knutsford Over                  ,3589,2135,17,178,1454
14EPFQ,Knutsford South                 ,3839,2386,9,80,1453
14EPFR,Knutsford West                  ,1676,953,7,54,723
14EPFS,Lacey Green                     ,3830,2322,14,156,1508
14EPFT,Macclesfield Central            ,7198,4881,41,198,2317
14EPFU,Macclesfield East               ,5806,3941,38,309,1865
14EPFW,Macclesfield North East         ,6709,4385,45,200,2324
14EPFX,Macclesfield North West         ,8025,5385,33,261,2640
14EPFY,Macclesfield South              ,5745,3598,29,257,2147
14EPFZ,Macclesfield West               ,5639,3672,32,250,1967
14EPGA,Mere                            ,1458,878,1,35,580
14EPGB,Mobberley                       ,2319,1275,7,53,1044
14EPGC,Morley and Styal                ,4176,2448,13,91,1728
14EPGD,Nether Alderley                 ,2638,1514,5,28,1124
14EPGE,Plumley                         ,2001,1053,4,40,948
14EPGF,Poynton Central                 ,5794,3545,18,125,2249
14EPGH,Poynton East                    ,1887,1259,6,36,628
14EPGJ,Poynton West                    ,4292,2809,34,132,1483
14EPGK,Prestbury                       ,4383,2482,8,93,1901
14EPGL,Rainow                          ,2252,1464,7,49,788
14EPGM,Sutton                          ,2506,1477,8,48,1029
14EPSS,Shipping                        ,0,0,0,0,0
14EQFA,Barnton                         ,4568,2886,30,143,1682
14EQFB,Castle                          ,5024,3192,36,226,1832
14EQFC,Church                          ,1824,1031,11,73,793
14EQFD,Cogshall                        ,1696,1098,6,39,598
14EQFE,Cuddington and Marton           ,5198,2992,14,155,2206
14EQFF,Davenham and Moulton            ,4507,2764,15,140,1743
14EQFG,Forest                          ,1334,686,8,33,648
14EQFH,Frodsham East                   ,2734,1639,13,75,1095
14EQFJ,Frodsham North West             ,2892,1701,19,161,1191
14EQFK,Frodsham South                  ,1709,1007,8,57,702
14EQFL,Gorst Wood                      ,3514,1893,33,145,1621
14EQFM,Gravel                          ,2992,1812,14,134,1180
14EQFN,Hartford                        ,3687,2145,16,78,1542
14EQFP,Helsby Central                  ,1294,750,12,33,544
14EQFQ,Helsby North                    ,1398,861,6,44,537
14EQFR,Helsby South and Alvanley       ,1456,858,7,40,598
14EQFS,Kingsley                        ,2403,1432,8,57,971
14EQFT,Lostock Gralam                  ,1818,1175,9,46,643
14EQFU,Mara                            ,1247,675,7,32,572
14EQFW,Marston and Wincham             ,2005,1352,13,44,653
14EQFX,Milton                          ,897,522,2,26,375
14EQFY,Northwich                       ,3385,2049,23,137,1336
14EQFZ,Oulton                          ,1590,962,6,50,628
14EQGA,Over One                        ,2984,1840,15,135,1144
14EQGB,Over Two                        ,3587,2192,42,507,1395
14EQGC,Rudheath and Whatcroft          ,2861,1707,24,89,1154
14EQGD,Seven Oaks                      ,1298,866,2,25,432
14EQGE,Shakerley                       ,1486,942,5,31,544
14EQGF,Swanlow                         ,3239,2092,27,177,1147
14EQGG,Tarporley                       ,1896,1137,13,43,759
14EQGH,Vale Royal                      ,5164,3252,34,357,1912
14EQGJ,Weaver                          ,0,0,0,0,0
14EQGK,Wharton                         ,2671,1664,29,213,1007
14EQGL,Winnington                      ,1110,723,11,46,387
14EQGM,Witton North                    ,2408,1488,21,87,920
14EQGN,Witton South                    ,2646,1478,23,120,1168
14EQSS,SHIPPING                        ,0,0,0,0,0
14ERFA,Appleton and Stretton           ,7165,4353,31,212,2812
14ERFB,Bewsey                          ,4018,2076,45,384,1942
14ERFC,Booths Hill                     ,2269,1340,14,42,929
14ERFD,Burtonwood                      ,7676,5577,63,350,2099
14ERFE,Croft                           ,11439,7936,85,554,3503
14ERFF,Culcheth and Glazebury          ,6017,3437,35,202,2580
14ERFG,Fairfield                       ,6217,3833,51,343,2384
14ERFH,Grappenhall and Thelwall        ,7092,4608,38,171,2484
14ERFJ,Great Sankey North              ,8169,5691,42,313,2478
14ERFK,Great Sankey South              ,6976,4948,71,352,2028
14ERFL,Heatley                         ,2333,1539,2,81,794
14ERFM,Howley                          ,3868,2046,37,271,1822
14ERFN,Hulme                           ,5593,2797,56,427,2796
14ERFP,Latchford                       ,5826,3715,52,310,2111
14ERFQ,Longford                        ,3733,1988,61,345,1745
14ERFR,Lymm                            ,2103,1305,7,55,798
14ERFS,Orford                          ,5746,3456,79,496,2290
14ERFT,Penketh and Cuerdley            ,7508,5136,62,303,2372
14ERFU,Poulton-With-Fearnhead North    ,8540,5547,109,548,2993
14ERFW,Poulton-With-Fearnhead South    ,4620,2926,36,170,1694
14ERFX,Rixton and Woolston             ,7415,5300,58,265,2115
14ERFY,Statham                         ,1599,1083,12,58,516
14ERFZ,Stockton Heath and Walton       ,6363,3826,42,225,2537
14ERGA,Westy                           ,5889,3355,70,468,2534
14ERGB,Whitecross                      ,3622,2237,41,281,1385
14ERGC,Winwick                         ,2758,1531,10,75,1227
14ERSS,Shipping                        ,0,0,0,0,0
15ESFA,Brinkburn                       ,4201,2459,69,372,1742
15ESFB,Brus                            ,4356,2183,110,490,2173
15ESFC,Dyke House                      ,5164,2919,143,626,2245
15ESFD,Elwick                          ,1295,799,6,39,496
15ESFE,Fens                            ,5173,3242,97,349,1931
15ESFF,Grange                          ,4924,2898,61,270,2026
15ESFG,Greatham                        ,1833,1166,21,81,667
15ESFH,Hart                            ,3353,2346,46,223,1007
15ESFJ,Jackson                         ,4086,2527,101,360,1559
15ESFK,Owton                           ,3936,2095,124,577,1841
15ESFL,Park                            ,4695,2418,76,326,2277
15ESFM,Rift House                      ,4677,2823,70,236,1854
15ESFN,Rossmere                        ,4160,2011,103,427,2149
15ESFP,St.Hilda                        ,5334,2727,142,704,2607
15ESFQ,Seaton                          ,4417,2694,65,210,1723
15ESFR,Stranton                        ,4134,2201,152,579,1933
15ESFS,Throston                        ,5016,3094,95,320,1922
15ESSS,Shipping                        ,0,0,0,0,0
15ETFA,Bankside                        ,4559,2537,76,316,2022
15ETFB,Belmont                         ,6311,4263,90,239,2048
15ETFC,Brotton                         ,4064,2507,84,196,1557
15ETFD,Church Lane                     ,3293,1773,74,365,1520
15ETFE,Coatham                         ,3530,2067,86,461,1463
15ETFF,Dormanstown                     ,5130,2682,101,395,2448
15ETFG,Easton                          ,4560,2526,72,344,2034
15ETFH,Grangetown                      ,2610,1333,62,453,1277
15ETFJ,Guisborough                     ,5342,2876,88,347,2466
15ETFK,Hutton                          ,3361,2185,27,79,1176
15ETFL,Kirkleatham                     ,6108,3143,144,511,2965
15ETFM,Lockwood                        ,2862,1644,46,168,1218
15ETFN,Loftus                          ,5558,3024,157,397,2534
15ETFP,Longbeck                        ,6533,4142,89,270,2391
15ETFQ,Newcomen                        ,3773,2034,61,336,1739
15ETFR,Normanby                        ,4046,2546,47,160,1500
15ETFS,Ormesby                         ,3218,1876,36,130,1342
15ETFT,Overfields                      ,3792,2224,66,371,1568
15ETFU,Redcar                          ,3843,2095,42,178,1748
15ETFW,St.Germain's                    ,3982,2132,63,184,1850
15ETFX,Saltburn                        ,5111,2714,65,334,2397
15ETFY,Skelton                         ,5032,2915,74,321,2117
15ETFZ,Skinningrove                    ,1325,705,35,125,620
15ETGA,South Bank                      ,4690,2534,130,770,2156
15ETGB,Teesville                       ,5202,3082,95,289,2120
15ETGC,West Dyke                       ,6145,3705,86,258,2440
15ETSS,Shipping                        ,0,0,0,0,0
15EUFA,Acklam                          ,4185,2524,36,165,1661
15EUFB,Ayresome                        ,4806,2646,89,587,2160
15EUFC,Beckfield                       ,4325,2299,76,540,2026
15EUFD,Beechwood                       ,3710,1667,89,515,2043
15EUFE,Berwick Hills                   ,3572,1656,88,365,1916
15EUFF,Brookfield                      ,5217,3486,54,190,1731
15EUFG,Easterside                      ,3542,1841,75,414,1701
15EUFH,Gresham                         ,3961,2531,77,504,1430
15EUFJ,Grove Hill                      ,4116,2228,86,443,1888
15EUFK,Hemlington                      ,3315,1827,88,399,1488
15EUFL,Kader                           ,5005,3007,40,181,1998
15EUFM,Kirby                           ,4268,2584,46,178,1684
15EUFN,Linthorpe                       ,4010,2529,69,299,1481
15EUFP,Marton                          ,3790,2564,44,127,1226
15EUFQ,Newham                          ,9558,5819,115,448,3739
15EUFR,North Ormesby                   ,4118,2404,90,505,1714
15EUFS,Nunthorpe                       ,4113,2656,33,103,1457
15EUFT,Pallister                       ,3251,1635,98,486,1616
15EUFU,Park                            ,3731,2066,50,249,1665
15EUFW,Park End                        ,4110,2020,121,517,2090
15EUFX,St.Hilda's                      ,3713,1824,101,574,1889
15EUFY,Southfield                      ,3299,1741,84,457,1558
15EUFZ,Stainton and Thornton           ,3773,2139,112,415,1634
15EUGA,Thorntree                       ,6075,2938,199,1010,3137
15EUGB,Westbourne                      ,3828,2075,87,550,1753
15EUSS,Shipping                        ,0,0,0,0,0
15EWFA,Bishopsgarth                    ,6057,4033,65,280,2024
15EWFB,Blue Hall                       ,4904,2799,90,605,2105
15EWFC,Charltons                       ,3943,2155,59,362,1788
15EWFD,Egglescliffe                    ,6271,4061,52,235,2210
15EWFE,Elm Tree                        ,3597,2109,35,149,1488
15EWFF,Fairfield                       ,3988,2296,25,160,1692
15EWFG,Glebe                           ,5066,3210,45,167,1856
15EWFH,Grange                          ,3418,2019,62,333,1399
15EWFJ,Grangefield                     ,4083,2524,61,230,1559
15EWFK,Hardwick                        ,3878,2045,114,494,1833
15EWFL,Hartburn                        ,5649,3667,66,177,1982
15EWFM,Ingleby Barwick                 ,4648,3464,33,120,1184
15EWFN,Mandale                         ,5214,3002,103,513,2212
15EWFP,Marsh House                     ,6594,4666,95,354,1928
15EWFQ,Mile House                      ,4539,2125,62,398,2414
15EWFR,Newtown                         ,4460,2504,89,534,1956
15EWFS,Northfield                      ,4051,2314,34,141,1737
15EWFT,Norton                          ,4974,2996,60,266,1978
15EWFU,Parkfield                       ,4992,3075,126,734,1917
15EWFW,Portrack And Tillery            ,4473,2408,109,713,2065
15EWFX,Preston                         ,2352,1496,29,96,856
15EWFY,Roseworth                       ,4375,2396,118,496,1979
15EWFZ,St.Aidan's                      ,3983,2041,59,306,1942
15EWGA,St.Cuthbert's                   ,4644,2705,78,306,1939
15EWGB,Stainsby                        ,4791,2829,97,476,1962
15EWGC,Victoria                        ,4032,2314,59,424,1718
15EWGD,Village                         ,4342,2474,74,345,1868
15EWGE,Whitton                         ,2662,1811,29,106,851
15EWGF,Wolviston                       ,1991,1338,21,68,653
15EWGG,Yarm                            ,6714,4531,48,247,2183
15EWSS,Shipping                        ,0,0,0,0,0
16EXFA,Burraton                        ,3219,1936,32,122,1283
16EXFB,Callington                      ,3454,2023,17,111,1431
16EXFC,Calstock and Harrowbarrow       ,1927,1098,15,79,829
16EXFD,Chilsworthy and Delaware        ,1398,773,8,69,625
16EXFE,Dobwalls and Trewidland         ,1679,992,27,76,687
16EXFF,Downderry                       ,1309,705,16,72,604
16EXFG,Essa                            ,3284,1959,33,169,1325
16EXFH,Gunnislake                      ,1406,824,13,80,582
16EXFJ,Landrake                        ,1811,1145,10,72,666
16EXFK,Lansallos                       ,1368,713,2,65,655
16EXFL,Lanteglos                       ,859,407,6,35,452
16EXFM,Liskeard North                  ,3090,1766,26,144,1324
16EXFN,Liskeard South                  ,3082,1687,22,150,1395
16EXFP,Looe                            ,4383,2218,30,236,2165
16EXFQ,Lynher                          ,1565,921,18,72,644
16EXFR,Maker                           ,900,420,9,42,480
16EXFS,Menheniot                       ,1349,814,13,54,535
16EXFT,Millbrook                       ,1456,763,11,94,693
16EXFU,Morval                          ,1402,788,13,52,614
16EXFW,Pill                            ,2421,1359,29,138,1062
16EXFX,St.Cleer                        ,2422,1375,19,95,1047
16EXFY,St.Dominick                     ,1255,744,5,34,511
16EXFZ,St.Germans                      ,1330,769,13,60,561
16EXGA,St.Ive                          ,1695,978,21,93,717
16EXGB,St.Neot and Warleggan           ,911,545,10,34,366
16EXGC,St.Stephens                     ,2089,1395,24,77,694
16EXGD,St.Veep                         ,1037,583,14,42,454
16EXGE,Sheviock                        ,1283,696,6,63,587
16EXGF,Torpoint                        ,6330,3962,72,307,2368
16EXGG,Trelawny                        ,1340,675,13,38,665
16EXSS,Shipping                        ,0,0,0,0,0
16EYFA,Arwenack                        ,2747,1213,30,135,1534
16EYFB,Boscawen                        ,4216,2383,30,219,1833
16EYFC,Chacewater                      ,1169,696,8,53,473
16EYFD,Feock                           ,3005,1382,14,66,1623
16EYFE,Kea                             ,1198,651,6,54,547
16EYFF,Kenwyn                          ,3452,2350,32,115,1102
16EYFG,Moresk                          ,2469,1292,15,77,1177
16EYFH,Mylor                           ,4551,2268,35,173,2283
16EYFJ,Newlyn                          ,2110,1163,18,100,947
16EYFK,Penryn                          ,4749,2799,61,298,1950
16EYFL,Penwerris                       ,4518,2245,63,343,2273
16EYFM,Perranzabuloe                   ,4257,2342,45,302,1915
16EYFN,Probus                          ,3419,2086,34,136,1333
16EYFP,Roseland                        ,2714,1263,17,63,1451
16EYFQ,St.Agnes                        ,5506,2727,46,317,2779
16EYFR,St.Clement                      ,2271,1438,21,89,833
16EYFS,Smithick                        ,3793,2129,38,185,1664
16EYFT,Tregolls                        ,2844,1641,20,176,1203
16EYFU,Trehaverne                      ,4120,2093,45,172,2027
16EYFW,Trevethan                       ,4643,2554,41,212,2089
16EYSS,Shipping                        ,0,0,0,0,0
16EZFA,Breage and Germoe               ,2710,1352,25,162,1358
16EZFB,Camborne North                  ,5121,2862,98,414,2259
16EZFC,Camborne South                  ,5157,2859,98,409,2298
16EZFD,Camborne West                   ,4974,2379,65,287,2595
16EZFE,Constantine and Gweek           ,1797,944,9,83,853
16EZFF,Crowan                          ,1749,1028,19,120,721
16EZFG,Grade-Ruan And Landewednack     ,1486,780,15,107,706
16EZFH,Helston North                   ,3541,2247,31,125,1294
16EZFJ,Helston South                   ,3020,1738,47,137,1282
16EZFK,Illogan North                   ,5304,2981,71,335,2323
16EZFL,Illogan South                   ,5212,2992,79,409,2220
16EZFM,Mabe and St.Gluvias             ,2019,1069,17,92,950
16EZFN,Mawnan And Budock               ,2390,1132,16,85,1258
16EZFP,Meneage                         ,1581,982,31,40,599
16EZFQ,Mullion                         ,2160,1087,15,114,1073
16EZFR,Porthleven                      ,2640,1388,19,127,1252
16EZFS,Redruth North                   ,5184,2931,94,453,2253
16EZFT,Redruth South                   ,4652,2718,58,264,1934
16EZFU,St.Day and Lanner               ,4258,2400,47,275,1858
16EZFW,St.Keverne                      ,1529,706,15,50,823
16EZFX,Stithians                       ,1597,934,24,86,663
16EZFY,Wendron and Sithney             ,2503,1520,40,125,983
16EZSS,Shipping                        ,0,0,0,0,0
16FAFA,Allan                           ,1218,657,4,55,561
16FAFB,Altarnun                        ,1957,1050,11,66,907
16FAFC,Bodmin St.Mary's                ,5012,2938,63,320,2074
16FAFD,Bodmin St.Petroc                ,4784,2918,44,288,1866
16FAFE,Bude and Poughill               ,5418,2705,33,244,2713
16FAFF,Camelford                       ,1693,958,18,69,735
16FAFG,Grenville                       ,1733,975,17,82,758
16FAFH,Lanivet                         ,1536,908,8,52,628
16FAFJ,Launceston North                ,3108,1970,23,118,1138
16FAFK,Launceston South                ,2068,1107,13,70,961
16FAFL,Lesnewth                        ,1690,952,10,87,738
16FAFM,North Petherwin                 ,1434,837,16,50,597
16FAFN,Ottery                          ,1096,600,10,48,496
16FAFP,Padstow and St.Merryn           ,3532,1751,26,183,1781
16FAFQ,Penfound                        ,1678,861,12,87,817
16FAFR,Rumford                         ,1775,1147,19,98,628
16FAFS,St.Breward                      ,1333,690,9,51,643
16FAFT,St.Endellion                    ,912,474,6,51,438
16FAFU,St.Minver                       ,1871,797,8,50,1074
16FAFW,St.Teath                        ,1709,830,12,79,879
16FAFX,South Petherwin                 ,1594,869,6,44,725
16FAFY,Stokeclimsland                  ,1793,1056,15,49,737
16FAFZ,Stratton                        ,1274,729,11,67,545
16FAGA,Tintagel                        ,1466,812,15,86,654
16FAGB,Trigg                           ,1225,721,9,53,504
16FAGC,Wadebridge                      ,5188,2912,33,209,2276
16FAGD,Week St.Mary                    ,1527,826,11,66,701
16FASS,Shipping                        ,0,0,0,0,0
16FBFA,Hayle-Gwinear                   ,3590,1992,32,237,1598
16FBFB,Hayle-Gwithian                  ,4554,2547,67,365,2007
16FBFC,Lelant and Carbis Bay           ,3146,1441,32,162,1705
16FBFD,Ludgvan                         ,3965,2290,48,237,1675
16FBFE,Marazion                        ,1211,549,17,53,662
16FBFF,Penzance Central                ,2923,1379,25,152,1544
16FBFG,Penzance East                   ,4140,2348,64,361,1792
16FBFH,Penzance North                  ,3103,1732,43,161,1371
16FBFJ,Penzance South                  ,3804,1993,42,208,1811
16FBFK,Penzance West                   ,2780,1262,45,163,1518
16FBFL,Perranuthnoe                    ,1565,719,15,56,846
16FBFM,St.Buryan                       ,2750,1488,31,127,1262
16FBFN,St.Erth and St.Hilary           ,1562,892,28,81,670
16FBFP,St.Ives North                   ,2946,1635,32,264,1311
16FBFQ,St.Ives South                   ,2955,1616,36,204,1339
16FBFR,St.Just                         ,3504,1946,45,236,1558
16FBSS,Shipping                        ,0,0,0,0,0
16FCFA,Crinnis                         ,3358,1717,35,152,1641
16FCFB,Edgcumbe                        ,6069,3608,57,426,2461
16FCFC,Fowey                           ,2035,950,12,99,1085
16FCFD,Gannel                          ,4921,2680,46,379,2241
16FCFE,Lostwithiel                     ,3307,1927,24,194,1380
16FCFF,Mevagissey                      ,3072,1536,39,125,1536
16FCFG,Poltair                         ,5124,3014,69,239,2110
16FCFH,Railton                         ,5337,3205,54,270,2132
16FCFJ,Rock                            ,3581,2065,55,188,1516
16FCFK,St.Blaise                       ,4743,2871,75,320,1872
16FCFL,ST.Columb                       ,3583,2042,28,168,1541
16FCFM,St.Enoder                       ,2538,1501,43,141,1037
16FCFN,St.Ewe                          ,1325,720,15,58,605
16FCFP,St.Mewan                        ,5203,2877,62,238,2326
16FCFQ,St.Stephen-In-Brannel           ,4414,2517,64,229,1897
16FCFR,Trevarna                        ,4774,2493,69,218,2281
16FCFS,Treverbyn                       ,4115,2489,68,274,1626
16FCFT,Tywardreath                     ,2564,1244,27,127,1320
16FCSS,Shipping                        ,0,0,0,0,0
16FDFA,Bryher                          ,0,0,0,0,0
16FDFB,St.Agnes                        ,0,0,0,0,0
16FDFC,St.Martin's                     ,0,0,0,0,0
16FDFD,St.Mary's                       ,1661,1141,2,31,520
16FDFE,Tresco                          ,0,0,0,0,0
16FDSS,Shipping                        ,0,0,0,0,0
17FEFA,All Saints                      ,3287,2074,18,169,1213
17FEFB,Aspatria                        ,2246,1275,36,95,971
17FEFC,Binsey                          ,1519,935,9,33,584
17FEFD,Boltons                         ,1563,981,17,52,582
17FEFE,Broughton                       ,1224,725,17,62,499
17FEFF,Castle                          ,2961,1697,23,94,1264
17FEFG,Clifton                         ,1344,753,14,113,591
17FEFH,Crummock                        ,1048,665,12,24,383
17FEFJ,Dalton                          ,1376,852,11,39,524
17FEFK,Dearham                         ,1534,927,15,79,607
17FEFL,Derwent Valley                  ,1717,1021,5,33,696
17FEFM,Ellen                           ,1576,917,8,63,659
17FEFN,Ellenborough                    ,3018,1776,47,216,1242
17FEFP,Ewanrigg                        ,2283,1158,46,225,1125
17FEFQ,Flimby                          ,1442,836,12,81,606
17FEFR,Harrington                      ,2331,1572,17,81,759
17FEFS,Keswick                         ,4100,2325,14,106,1775
17FEFT,Marsh                           ,1776,1107,15,47,669
17FEFU,Moorclose                       ,3374,1995,59,248,1379
17FEFW,Netherhall                      ,2485,1414,39,161,1071
17FEFX,Northside                       ,973,539,11,113,434
17FEFY,St.Bridget's                    ,1728,1005,9,33,723
17FEFZ,St.John's                       ,3655,2268,42,164,1387
17FEGA,St.Michael's                    ,3624,2194,68,238,1430
17FEGB,Salterbeck                      ,2418,1346,49,308,1072
17FEGC,Seaton Moor                     ,4634,2957,56,186,1677
17FEGD,Silloth                         ,2434,1314,34,141,1120
17FEGE,Stainburn                       ,2265,1466,24,76,799
17FEGF,Tarns                           ,1441,879,23,39,562
17FEGG,Wampool                         ,1726,1119,9,36,607
17FEGH,Warnell                         ,1452,947,10,39,505
17FEGJ,Waver                           ,1571,1014,17,55,557
17FEGK,Westfield                       ,2978,1600,68,268,1378
17FEGL,Wigton                          ,4264,2585,42,192,1679
17FESS,Shipping                        ,0,0,0,0,0
17FFFA,Barrow Island                   ,2887,1898,28,197,989
17FFFB,Central                         ,4465,2730,74,362,1735
17FFFC,Dalton North                    ,4680,3080,23,168,1600
17FFFD,Dalton South                    ,4686,3097,33,196,1589
17FFFE,Hawcoat                         ,4677,2637,34,106,2040
17FFFF,Hindpool                        ,4693,2659,46,325,2034
17FFFG,Newbarns                        ,4706,2698,47,241,2008
17FFFH,Ormsgill                        ,5257,3168,58,359,2089
17FFFJ,Parkside                        ,4345,2756,37,182,1589
17FFFK,Risedale                        ,4080,2361,71,319,1719
17FFFL,Roosecote                       ,4647,3017,36,197,1630
17FFFM,Walney North                    ,4411,2575,60,217,1836
17FFFN,Walney South                    ,4915,3009,43,163,1906
17FFSS,Shipping                        ,0,0,0,0,0
17FGFA,Arthuret                        ,2407,1503,14,132,904
17FGFB,Belah                           ,5691,3577,34,143,2114
17FGFC,Belle Vue                       ,4445,2840,44,342,1605
17FGFD,Botcherby                       ,4542,2707,37,319,1835
17FGFE,Brampton                        ,3178,1821,23,141,1357
17FGFF,Burgh                           ,1834,1189,13,49,645
17FGFG,Currock                         ,4588,2998,69,237,1590
17FGFH,Dalston                         ,1979,1123,8,50,856
17FGFJ,Denton Holme                    ,4584,2969,43,242,1615
17FGFK,Great Corby and Geltsdale       ,1477,932,11,38,545
17FGFL,Harraby                         ,4849,3069,33,217,1780
17FGFM,Hayton                          ,1769,1114,25,38,655
17FGFN,Irthing                         ,1601,1068,12,53,533
17FGFP,Lyne                            ,1845,1214,14,56,631
17FGFQ,Morton                          ,3932,2029,17,142,1903
17FGFR,St Aidans                       ,4574,3125,36,221,1449
17FGFS,St Cuthbert Without             ,1770,942,11,38,828
17FGFT,Stanwix Rural                   ,3914,2483,28,83,1431
17FGFU,Stanwix Urban                   ,4584,2764,39,266,1820
17FGFW,Trinity                         ,4315,2760,39,232,1555
17FGFX,Upperby                         ,4492,2557,41,259,1935
17FGFY,Wetheral                        ,3137,1861,14,51,1276
17FGFZ,Yewdale                         ,5673,3987,58,234,1686
17FGSS,Shipping                        ,0,0,0,0,0
17FHFA,Beckermet                       ,2480,1552,23,80,928
17FHFB,Bootle                          ,1212,725,13,21,487
17FHFC,Bransty                         ,3228,2089,31,113,1139
17FHFD,Cleator Moor North              ,3680,2319,33,238,1361
17FHFE,Cleator Moor South              ,2437,1483,30,178,954
17FHFF,Distington                      ,2035,1147,24,150,888
17FHFG,Egremont North                  ,3397,2239,32,228,1158
17FHFH,Egremont South                  ,2641,1583,23,109,1058
17FHFJ,Ennerdale                       ,1556,1040,15,69,516
17FHFK,Frizington                      ,1989,1237,31,131,752
17FHFL,Gosforth                        ,1279,791,11,17,488
17FHFM,Harbour                         ,2941,1586,22,165,1355
17FHFN,Haverigg                        ,851,494,7,34,357
17FHFP,Hensingham                      ,3081,1909,37,175,1172
17FHFQ,Hillcrest                       ,2915,2120,24,67,795
17FHFR,Holborn Hill                    ,2098,1272,25,125,826
17FHFS,Howgate                         ,2424,1485,39,133,939
17FHFT,Kells                           ,2149,1246,20,105,903
17FHFU,Melthwaite                      ,1248,774,4,34,474
17FHFW,Millom Without                  ,1093,644,8,24,449
17FHFX,Mirehouse East                  ,1943,1042,16,108,901
17FHFY,Mirehouse West                  ,1951,1112,24,239,839
17FHFZ,Newtown                         ,2987,1763,30,133,1224
17FHGA,St.Bees                         ,1311,818,4,39,493
17FHGB,Sandwith                        ,2178,1211,39,316,967
17FHGC,Seascale                        ,1436,848,8,25,588
17FHSS,Shipping                        ,0,0,0,0,0
17FJFA,Alston Moor                     ,1659,992,18,98,667
17FJFB,Appleby                         ,1170,659,2,32,511
17FJFC,Appleby Bongate                 ,996,602,3,29,394
17FJFD,Askham                          ,0,0,0,0,0
17FJFE,Brough                          ,952,606,5,26,346
17FJFF,Crosby Ravensworth              ,1713,1067,14,34,646
17FJFG,Dacre                           ,1765,1096,7,29,669
17FJFH,Eamont                          ,1124,665,4,27,459
17FJFJ,Greystoke                       ,1200,728,12,23,472
17FJFK,Hartside                        ,819,499,4,18,320
17FJFL,Hesket                          ,1991,1314,10,45,677
17FJFM,Kirkby Stephen                  ,1832,1047,11,24,785
17FJFN,Kirkby Thore                    ,1010,626,12,35,384
17FJFP,Kirkoswald                      ,1003,660,9,11,343
17FJFQ,Langwathby                      ,1080,692,10,16,388
17FJFR,Lazonby                         ,952,557,6,8,395
17FJFS,Long Marton                     ,0,0,0,0,0
17FJFT,Lowther                         ,1197,795,12,19,402
17FJFU,Orton With Tebay                ,1759,1122,13,23,637
17FJFW,Penrith East                    ,4022,2311,26,120,1711
17FJFX,Penrith North                   ,3329,2104,20,96,1225
17FJFY,Penrith South                   ,2016,1256,15,65,760
17FJFZ,Penrith West                    ,1672,1143,17,49,529
17FJGA,Ravenstonedale                  ,0,0,0,0,0
17FJGB,Shap                            ,1059,695,4,13,364
17FJGC,Skelton                         ,1092,769,6,19,323
17FJGD,Ullswater                       ,1030,687,5,17,343
17FJGE,Warcop                          ,950,596,5,16,354
17FJSS,Shipping                        ,0,0,0,0,0
17FKFA,Arnside                         ,1909,796,9,27,1113
17FKFB,Beetham                         ,1413,715,5,16,698
17FKFC,Broughton                       ,1918,1151,16,44,767
17FKFD,Burneside                       ,1569,1017,12,33,552
17FKFE,Burton And Holme                ,1985,1228,6,31,757
17FKFF,Cartmel                         ,1568,768,5,20,800
17FKFG,Cartmel Fell                    ,1335,790,4,15,545
17FKFH,Colton and Haverthwaite         ,1393,845,12,17,548
17FKFJ,Coniston                        ,1116,703,9,11,413
17FKFK,Crake Valley                    ,1252,781,12,35,471
17FKFL,Endmoor                         ,2040,1278,8,31,762
17FKFM,Grange                          ,3445,1400,13,63,2045
17FKFN,Hawkshead                       ,1044,659,4,9,385
17FKFP,Holker                          ,1439,818,3,21,621
17FKFQ,Hutton                          ,1036,700,12,14,336
17FKFR,Kendal Castle                   ,1884,1234,9,32,650
17FKFS,Kendal Far Cross                ,1508,924,13,44,584
17FKFT,Kendal Fell                     ,1590,1000,7,48,590
17FKFU,Kendal Glebelands               ,1899,1303,14,79,596
17FKFW,Kendal Heron Hill               ,1853,1234,15,29,619
17FKFX,Kendal Highgate                 ,1719,1027,10,49,692
17FKFY,Kendal Mintsfeet                ,1447,1000,10,32,447
17FKFZ,Kendal Nether                   ,1830,1103,11,58,727
17FKGA,Kendal Oxenholme                ,1770,1336,8,31,434
17FKGB,Kendal Stonecross               ,1813,977,5,27,836
17FKGC,Kendal Strickland               ,1539,1009,8,57,530
17FKGD,Kendal Underley                 ,1356,760,4,28,596
17FKGE,Kirkby Lonsdale                 ,1754,990,6,24,764
17FKGF,Lakes Ambleside                 ,2883,1797,12,60,1086
17FKGG,Lakes Grasmere                  ,1386,921,9,23,465
17FKGH,Levens                          ,1482,850,12,23,632
17FKGJ,Low Furness                     ,2230,1294,11,36,936
17FKGK,Lyth Valley                     ,1221,750,7,18,471
17FKGL,Milnthorpe                      ,2142,1257,10,36,885
17FKGM,Pennington                      ,1463,940,9,33,523
17FKGN,Sedbergh                        ,2547,1545,16,48,1002
17FKGP,Staveley-In-Westmorland         ,1364,804,1,23,560
17FKGQ,Ulverston Central               ,1325,816,10,48,509
17FKGR,Ulverston East                  ,1334,876,10,84,458
17FKGS,Ulverston North                 ,1442,810,9,22,632
17FKGT,Ulverston South                 ,3096,1958,14,117,1138
17FKGU,Ulverston West                  ,2513,1442,15,59,1071
17FKGW,Whinfell                        ,958,674,6,11,284
17FKGX,Windermere Applethwaite         ,1373,645,10,22,728
17FKGY,Windermere Bowness North        ,1920,1147,2,37,773
17FKGZ,Windermere Bowness South        ,1696,1084,4,51,612
17FKHA,Windermere Town                 ,1874,1287,16,45,587
17FKSS,Shipping                        ,0,0,0,0,0
18FLFA,Aldercar                        ,4030,2437,25,269,1593
18FLFB,Alfreton East                   ,2582,1621,14,155,961
18FLFC,Alfreton West                   ,4170,2175,27,210,1995
18FLFD,Alport                          ,2053,1201,9,47,852
18FLFE,Belper East                     ,6642,4381,37,246,2261
18FLFF,Belper North                    ,4075,2524,16,137,1551
18FLFG,Belper South                    ,3275,1975,10,126,1300
18FLFH,Codnor                          ,2471,1633,9,132,838
18FLFJ,Crich                           ,1888,1155,7,65,733
18FLFK,Denby and Horsley Woodhouse     ,2609,1673,15,81,936
18FLFL,Duffield                        ,3684,2014,9,92,1670
18FLFM,Heage and Ambergate             ,4022,2581,15,135,1441
18FLFN,Heanor and Loscoe               ,4035,2496,16,182,1539
18FLFP,Heanor East                     ,4503,2802,37,248,1701
18FLFQ,Heanor West                     ,4790,3047,25,261,1743
18FLFR,Holbrook and Horsley            ,1921,1119,8,44,802
18FLFS,Kilburn                         ,3059,2077,26,142,982
18FLFT,Riddings                        ,4376,2641,28,270,1735
18FLFU,Ripley                          ,7431,4674,53,299,2757
18FLFW,Ripley and Marehay              ,4515,2706,30,205,1809
18FLFX,Shipley Park                    ,2597,1507,7,81,1090
18FLFY,Somercotes                      ,4591,2728,26,269,1863
18FLFZ,South West Parishes             ,2121,1245,7,48,876
18FLGA,Swanwick                        ,3968,2685,23,123,1283
18FLGB,Wingfield                       ,1868,1131,4,57,737
18FLSS,Shipping                        ,0,0,0,0,0
18FMFA,Ault Hucknall                   ,0,0,0,0,0
18FMFB,Barlborough                     ,1587,915,19,67,672
18FMFC,Blackwell                       ,3388,1929,23,150,1459
18FMFD,Bolsover Central                ,2406,1352,46,155,1054
18FMFE,Bolsover North                  ,1406,819,15,92,587
18FMFF,Bolsover South                  ,2647,1270,31,107,1377
18FMFG,Bolsover West                   ,2593,1657,38,176,936
18FMFH,Clowne                          ,5819,3424,61,335,2395
18FMFJ,Elmton-With-Creswell            ,4024,2068,50,260,1956
18FMFK,Glapwell                        ,2063,1131,21,134,932
18FMFL,Pinxton                         ,4036,2370,24,195,1666
18FMFM,Pleasley                        ,1899,1055,19,112,844
18FMFN,Scarcliffe East                 ,1999,1056,31,143,943
18FMFP,Scarcliffe North                ,1067,492,22,114,575
18FMFQ,Scarcliffe South                ,1455,773,25,61,682
18FMFR,Shirebrook East                 ,1204,649,16,107,555
18FMFS,Shirebrook North                ,997,485,14,78,512
18FMFT,Shirebrook North-West           ,1331,582,31,113,749
18FMFU,Shirebrook South                ,1504,834,36,129,670
18FMFW,Shirebrook South-West           ,2361,1298,33,167,1063
18FMFX,South Normanton East            ,3238,1869,17,183,1369
18FMFY,South Normanton West            ,3253,2017,16,155,1236
18FMFZ,Tibshelf                        ,2792,1580,30,153,1212
18FMGA,Whitwell                        ,3913,2202,54,212,1711
18FMSS,Shipping                        ,0,0,0,0,0
18FNFA,Barrow Hill and Hollingwood     ,2330,1395,22,179,935
18FNFB,Brimington North                ,3863,2488,52,238,1375
18FNFC,Brimington South                ,4098,2355,36,141,1743
18FNFD,Brockwell                       ,4796,2894,41,238,1902
18FNFE,Dunston                         ,4984,2630,52,342,2354
18FNFF,Hasland                         ,5395,3472,45,229,1923
18FNFG,Holmebrook                      ,4134,2510,67,298,1624
18FNFH,Inkersall                       ,2949,1832,43,149,1117
18FNFJ,Lowgates and Woodthorpe         ,3793,2163,59,320,1630
18FNFK,Markham                         ,1206,602,23,131,604
18FNFL,Middlecroft                     ,2899,1554,45,279,1345
18FNFM,Moor                            ,4024,2324,55,256,1700
18FNFN,Newbold                         ,5886,3608,52,326,2278
18FNFP,New Whittington                 ,3917,2420,33,198,1497
18FNFQ,Old Whittington                 ,3478,1971,31,234,1507
18FNFR,Rother                          ,5381,2916,109,472,2465
18FNFS,St.Helen's                      ,4166,2384,60,350,1782
18FNFT,St.Leonard's                    ,3430,2222,36,222,1208
18FNFU,Walton                          ,6526,4077,47,164,2449
18FNFW,West                            ,3658,2069,22,107,1589
18FNSS,Shipping                        ,0,0,0,0,0
18FPFA,Abbey                           ,9673,6038,86,822,3635
18FPFB,Allestree                       ,8000,4755,36,185,3245
18FPFC,Alvaston                        ,8416,5300,68,522,3116
18FPFD,Babington                       ,7995,4533,117,1102,3462
18FPFE,Blagreaves                      ,8465,5296,48,301,3169
18FPFF,Boulton                         ,9258,5754,68,461,3504
18FPFG,Breadsall                       ,14279,9980,93,611,4299
18FPFH,Chaddesden                      ,8743,5449,69,438,3294
18FPFJ,Chellaston                      ,9753,5927,54,357,3826
18FPFK,Darley                          ,9692,5451,54,392,4241
18FPFL,Derwent                         ,7859,4590,84,766,3269
18FPFM,Kingsway                        ,7811,4540,39,285,3271
18FPFN,Litchurch                       ,7932,4449,113,1113,3483
18FPFP,Littleover                      ,7417,4376,46,296,3041
18FPFQ,Mackworth                       ,6854,3747,56,351,3107
18FPFR,Mickleover                      ,8557,5857,63,194,2700
18FPFS,Normanton                       ,7636,4307,66,621,3329
18FPFT,Osmaston                        ,6252,3537,82,722,2715
18FPFU,Sinfin                          ,7916,5300,84,659,2616
18FPFW,Spondon                         ,10377,6843,75,388,3534
18FPSS,Shipping                        ,0,0,0,0,0
18FQFA,All Saints                      ,4134,2674,21,127,1460
18FQFB,Ashbourne                       ,5174,3089,27,163,2085
18FQFC,Ashford and Longstone           ,1400,834,4,17,566
18FQFD,Bakewell                        ,3255,1708,5,79,1547
18FQFE,Baslow                          ,1506,830,2,36,676
18FQFF,Bradwell                        ,1459,908,8,46,551
18FQFG,Brailsford                      ,1359,851,2,29,508
18FQFH,Brassington and Parwich         ,1483,945,5,33,538
18FQFJ,Calver                          ,1137,611,7,31,526
18FQFK,Clifton and Bradley             ,1418,855,4,31,563
18FQFL,Darley Dale                     ,4464,2661,24,99,1803
18FQFM,Doveridge                       ,1658,947,5,35,711
18FQFN,Eyam and Stoney Middleton       ,1360,848,6,36,512
18FQFP,Hartington and Dovedale         ,1319,836,5,21,483
18FQFQ,Hathersage                      ,2358,1335,9,50,1023
18FQFR,Hulland                         ,1679,1076,6,45,603
18FQFS,Masson                          ,2774,1765,15,107,1009
18FQFT,Norbury                         ,1303,819,8,35,484
18FQFU,St.Giles and Tansley            ,4537,2719,23,204,1818
18FQFW,Stanton                         ,1325,828,9,56,497
18FQFX,Taddington                      ,1261,817,3,29,444
18FQFY,Tideswell                       ,1880,1135,10,48,745
18FQFZ,Winster and South Darley        ,1199,759,2,38,440
18FQGA,Wirksworth                      ,4664,2963,34,160,1701
18FQGB,Youlgreave                      ,1374,793,12,36,581
18FQSS,Shipping                        ,0,0,0,0,0
18FRFA,Abbotsford                      ,2004,1384,13,94,620
18FRFB,Breadsall and Morley            ,1027,623,5,42,404
18FRFC,Breaston                        ,3751,2272,14,95,1479
18FRFD,Cotmanhay                       ,4499,2926,38,253,1573
18FRFE,Dale Abbey                      ,1186,665,6,18,521
18FRFF,Derby Road East                 ,4204,2827,32,231,1377
18FRFG,Derby Road West                 ,5052,3034,29,237,2018
18FRFH,Draycott                        ,2238,1491,12,97,747
18FRFJ,Ilkeston Central                ,4450,2938,28,308,1512
18FRFK,Ilkeston North                  ,2705,1293,38,282,1412
18FRFL,Ilkeston South                  ,2897,1781,15,135,1116
18FRFM,Kirk Hallam North               ,2965,1726,19,152,1239
18FRFN,Kirk Hallam South               ,2455,1377,38,161,1078
18FRFP,Little Eaton                    ,1956,1244,8,60,712
18FRFQ,Long Eaton Central              ,4308,3143,38,217,1165
18FRFR,Nottingham Road                 ,4993,3375,28,266,1618
18FRFS,Ockbrook And Borrowash          ,5701,3572,40,224,2129
18FRFT,Old Park                        ,3007,1841,16,190,1166
18FRFU,Sandiacre North                 ,3430,2087,41,163,1343
18FRFW,Sandiacre South                 ,3490,2466,17,125,1024
18FRFX,Sawley                          ,5715,3681,38,262,2034
18FRFY,Stanley                         ,1791,1106,7,80,685
18FRFZ,Victoria                        ,3087,1764,21,126,1323
18FRGA,West Hallam                     ,3865,2598,8,91,1267
18FRGB,Wilsthorpe                      ,4473,3238,25,189,1235
18FRSS,Shipping                        ,0,0,0,0,0
18FSFA,All Saints                      ,5206,3299,30,260,1907
18FSFB,Barmoor                         ,1092,697,8,31,395
18FSFC,Barms                           ,2994,2004,17,101,990
18FSFD,Blackbrook                      ,2806,1829,9,90,977
18FSFE,Central                         ,1570,998,8,93,572
18FSFF,Chapel East                     ,1561,1000,7,50,561
18FSFG,Chapel West                     ,3559,2326,15,130,1233
18FSFH,College                         ,2792,1741,14,68,1051
18FSFJ,Corbar                          ,2838,1424,11,97,1414
18FSFK,Cote Heath                      ,3567,2387,18,107,1180
18FSFL,Gamesley                        ,2510,1420,40,262,1090
18FSFM,Hayfield                        ,2068,1330,12,64,738
18FSFN,Ladybower                       ,1280,738,4,57,542
18FSFP,Limestone Peak                  ,1253,809,3,44,444
18FSFQ,New Mills North                 ,4144,2819,17,132,1325
18FSFR,New Mills South                 ,3188,1955,12,137,1233
18FSFS,Peveril                         ,1714,1045,2,40,669
18FSFT,St.Andrews                      ,3186,2250,14,125,936
18FSFU,St.Charles                      ,3295,2209,15,182,1086
18FSFW,St.James                        ,4379,2929,21,165,1450
18FSFX,St.Johns                        ,1878,1292,14,50,586
18FSFY,Simmondley                      ,2227,1624,10,80,603
18FSFZ,Stone Bench                     ,2743,1709,14,185,1034
18FSGA,Tintwistle                      ,1080,692,6,52,388
18FSGB,Whaley Bridge                   ,4791,3003,27,133,1788
18FSSS,Shipping                        ,0,0,0,0,0
18FTFA,Ashover                         ,1502,880,14,37,622
18FTFB,Barlow and Holmesfield          ,1690,979,12,52,711
18FTFC,Brampton and Walton             ,2465,1380,15,69,1085
18FTFD,Clay Cross North                ,4441,2451,39,264,1990
18FTFE,Clay Cross South                ,2718,1523,41,202,1195
18FTFF,Coal Aston                      ,2835,1842,19,95,993
18FTFG,Dronfield North                 ,3859,2346,31,175,1513
18FTFH,Dronfield South                 ,5391,3720,27,168,1671
18FTFJ,Dronfield Woodhouse             ,1645,1011,5,55,634
18FTFK,Eckington North                 ,3142,2006,35,180,1136
18FTFL,Eckington South                 ,2671,1392,44,218,1279
18FTFM,Gosforth Valley                 ,4848,3367,26,135,1481
18FTFN,Hasland                         ,3172,1857,51,240,1315
18FTFP,Holmewood and Heath             ,2451,1229,27,260,1222
18FTFQ,Killamarsh East                 ,1907,1172,21,122,735
18FTFR,Killamarsh West                 ,4823,3176,48,257,1647
18FTFS,Morton                          ,1631,967,9,53,664
18FTFT,North Wingfield Central         ,4877,2904,45,344,1973
18FTFU,Pilsley                         ,2660,1604,33,140,1056
18FTFW,Renishaw                        ,1465,821,24,117,644
18FTFX,Ridgeway and Marsh Lane         ,1543,886,14,86,657
18FTFY,Shirland                        ,4308,2455,15,271,1853
18FTFZ,Sutton                          ,3345,1894,40,173,1451
18FTGA,Tupton                          ,2416,1363,26,163,1053
18FTGB,Unstone                         ,1610,972,11,104,638
18FTGC,Wingerworth                     ,5616,3508,26,188,2108
18FTSS,Shipping                        ,0,0,0,0,0
18FUFA,Aston                           ,3557,2254,15,87,1303
18FUFB,Etwall                          ,4087,2468,27,92,1619
18FUFC,Gresley                         ,5433,3490,48,231,1943
18FUFD,Hartshorne                      ,2955,1631,17,159,1324
18FUFE,Hatton                          ,1988,1320,15,69,668
18FUFF,Hilton                          ,1927,1215,14,51,712
18FUFG,Linton                          ,3220,1980,32,147,1240
18FUFH,Melbourne                       ,3692,2357,15,76,1335
18FUFJ,Midway                          ,5045,3101,46,226,1944
18FUFK,Netherseal                      ,1387,775,6,56,612
18FUFL,Newhall                         ,5400,3433,51,270,1967
18FUFM,North West                      ,1484,956,12,29,528
18FUFN,Overseal                        ,1641,935,12,58,706
18FUFP,Repton                          ,2980,1777,11,52,1203
18FUFQ,Swadlincote                     ,3698,2134,27,165,1564
18FUFR,Ticknall                        ,3764,2822,19,134,942
18FUFS,Walton                          ,1322,844,9,42,478
18FUFT,Willington                      ,1826,1268,12,54,558
18FUFU,Woodville                       ,2064,1300,15,96,764
18FUSS,SHIPPING                        ,0,0,0,0,0
19FWFA,Axminster Hamlets               ,1387,701,6,45,686
19FWFB,Axminster Town                  ,2998,1455,12,82,1543
19FWFC,Beer                            ,1168,625,6,35,543
19FWFD,Broadclyst                      ,2498,1555,13,63,943
19FWFE,Budleigh Salterton              ,4210,1466,12,95,2744
19FWFF,Clystbeare                      ,1407,902,12,31,505
19FWFG,Clyst Valley                    ,1625,921,7,43,704
19FWFH,Colyton                         ,2396,1057,10,51,1339
19FWFJ,Edenvale                        ,1647,901,3,47,746
19FWFK,Exe Valley                      ,1630,977,9,46,653
19FWFL,Exmouth Brixington              ,5764,3354,41,172,2410
19FWFM,Exmouth Halsdon                 ,4143,1841,18,100,2302
19FWFN,Exmouth Littleham Rural         ,4327,1793,18,143,2534
19FWFP,Exmouth Littleham Urban         ,2963,1422,27,171,1541
19FWFQ,Exmouth Withycombe Raleigh      ,4657,2929,46,200,1728
19FWFR,Exmouth Withycombe Urban        ,3274,1969,35,153,1305
19FWFS,Honiton St.Michaels             ,3633,2266,36,148,1367
19FWFT,Honiton St.Pauls                ,3738,1781,15,133,1957
19FWFU,Lympstone                       ,1478,802,7,48,676
19FWFW,Newbridges                      ,1587,764,10,57,823
19FWFX,Newton Poppleford and Harpford  ,1491,731,9,44,760
19FWFY,Otterhead                       ,2077,1237,8,85,840
19FWFZ,Ottery St.Mary Rural            ,3694,1913,15,89,1781
19FWGA,Ottery St.Mary Town             ,3362,1834,24,83,1528
19FWGB,Patteson                        ,2298,1331,13,50,967
19FWGC,Raleigh                         ,1733,856,15,40,877
19FWGD,Seaton                          ,5526,2210,19,168,3316
19FWGE,Sidmouth Rural                  ,4808,1889,18,98,2919
19FWGF,Sidmouth Town                   ,2893,877,4,37,2016
19FWGG,Sidmouth Woolbrook              ,3743,1764,25,94,1979
19FWGH,Tale Vale                       ,1680,1033,9,45,647
19FWGJ,Trinity                         ,1789,830,12,30,959
19FWGK,Upper Axe                       ,1405,701,3,41,704
19FWGL,Woodbury                        ,2653,1715,75,52,938
19FWGM,Yarty                           ,1642,827,5,45,815
19FWSS,Shipping                        ,0,0,0,0,0
19FXFA,Alphington                      ,6038,4045,50,162,1993
19FXFB,Barton                          ,3978,2316,37,146,1662
19FXFC,Countess Wear                   ,3726,2194,28,119,1532
19FXFD,Cowick                          ,4600,2693,45,184,1907
19FXFE,Exwick                          ,5826,4321,53,246,1505
19FXFF,Heavitree                       ,4184,2595,36,157,1589
19FXFG,Pennsylvania                    ,5025,3267,52,233,1758
19FXFH,Pinhoe                          ,4162,2387,29,109,1775
19FXFJ,Polsoe                          ,4027,2668,51,244,1359
19FXFK,Rougemont                       ,4774,2845,52,342,1929
19FXFL,St David's                      ,4240,2556,41,215,1684
19FXFM,St Leonard's                    ,4605,2498,37,215,2107
19FXFN,St.Loye's                       ,4127,2789,38,152,1338
19FXFP,St.Thomas                       ,4630,3071,46,231,1559
19FXFQ,Stoke Hill                      ,4554,3031,43,244,1523
19FXFR,Topsham                         ,3635,1794,26,83,1841
19FXFS,Whipton                         ,3724,1978,32,198,1746
19FXFT,Wonford                         ,3972,2466,63,326,1506
19FXSS,Shipping                        ,0,0,0,0,0
19FYFA,Boniface                        ,2446,1568,16,81,878
19FYFB,Bradninch                       ,1399,810,3,29,589
19FYFC,Cadbury                         ,1513,896,9,41,617
19FYFD,Canal                           ,3220,1862,24,121,1358
19FYFE,Canonsleigh                     ,1396,862,18,43,534
19FYFF,Castle                          ,3100,1800,29,128,1300
19FYFG,Clare                           ,1047,644,7,28,403
19FYFH,Cullompton Outer                ,1167,703,3,23,464
19FYFJ,Cullompton Town                 ,4391,2728,42,151,1663
19FYFK,Culm                            ,2575,1474,17,73,1101
19FYFL,East Creedy                     ,973,589,2,28,384
19FYFM,Halberton                       ,1091,650,5,35,441
19FYFN,Lawrence                        ,2604,1449,16,67,1155
19FYFP,Lowman                          ,3190,1973,26,170,1217
19FYFQ,Newbrooke                       ,1137,672,5,38,465
19FYFR,Paullet                         ,1083,665,7,32,418
19FYFS,Sandford                        ,1028,647,8,34,381
19FYFT,Shuttern                        ,1568,863,12,48,705
19FYFU,Silverton                       ,1398,831,8,44,567
19FYFW,Taw                             ,1272,796,10,56,476
19FYFX,Taw Vale                        ,1250,740,7,45,510
19FYFY,Upper Culm                      ,1673,952,12,33,721
19FYFZ,Upper Yeo                       ,1238,850,10,33,388
19FYGA,West Creedy                     ,1326,770,14,41,556
19FYGB,Westexe North                   ,2096,1197,18,60,899
19FYGC,Westexe South                   ,2317,1345,26,108,972
19FYGD,Willand                         ,1747,1010,15,44,737
19FYGE,Yeo                             ,2163,1445,19,58,718
19FYSS,Shipping                        ,0,0,0,0,0
19FZFA,Bishop's Nympton                ,1507,758,10,57,749
19FZFB,Bishop's Tawton                 ,1311,785,7,38,526
19FZFC,Bratton Fleming                 ,1439,891,9,48,548
19FZFD,Braunton East                   ,3138,1821,19,111,1317
19FZFE,Braunton West                   ,3249,1585,19,101,1664
19FZFF,Chittlehampton                  ,1517,914,7,56,603
19FZFG,Chulmleigh                      ,1634,897,18,57,737
19FZFH,Combe Martin                    ,2660,1421,16,133,1239
19FZFJ,Fremington                      ,6085,3335,41,216,2750
19FZFK,Georgeham                       ,1263,652,9,42,611
19FZFL,Heanton Punchardon              ,2057,1415,15,67,642
19FZFM,Ilfracombe Central              ,3134,1665,22,275,1469
19FZFN,Ilfracombe East                 ,2515,1536,19,175,979
19FZFP,Ilfracombe West                 ,3275,1838,28,176,1437
19FZFQ,Instow                          ,1399,732,6,45,667
19FZFR,Landkey                         ,1901,1277,13,79,624
19FZFS,Longbridge                      ,1288,795,16,75,493
19FZFT,Lynton and Lynmouth             ,1571,1011,8,54,560
19FZFU,Marwood                         ,1395,928,10,55,467
19FZFW,Mortehoe                        ,1854,1123,5,84,731
19FZFX,Newport                         ,3089,1822,28,148,1267
19FZFY,North Molton                    ,1119,680,7,29,439
19FZFZ,Pilton                          ,3209,2078,31,92,1131
19FZGA,St Mary's                       ,2647,1640,24,160,1007
19FZGB,South Molton                    ,3434,1992,34,117,1442
19FZGC,Swimbridge                      ,1644,1021,4,60,623
19FZGD,Tawstock                        ,1766,983,13,51,783
19FZGE,Trinity                         ,3714,2294,51,265,1420
19FZGF,Witheridge                      ,1600,849,9,48,751
19FZGG,Yeo                             ,2608,1699,33,200,909
19FZSS,Shipping                        ,0,0,0,0,0
19GAFA,Budshead                        ,9486,5391,138,783,4095
19GAFB,Compton                         ,8652,5081,84,463,3571
19GAFC,Drake                           ,10128,5755,139,770,4373
19GAFD,Efford                          ,9445,5726,135,649,3719
19GAFE,Eggbuckland                     ,10260,6387,118,408,3873
19GAFF,Estover                         ,11734,7344,134,512,4390
19GAFG,Ham                             ,8529,4892,167,816,3637
19GAFH,Honicknowle                     ,9857,5160,123,642,4697
19GAFJ,Keyham                          ,10883,7285,232,933,3598
19GAFK,Mount Gould                     ,8512,4928,118,687,3584
19GAFL,Plympton Erle                   ,12441,8607,128,511,3834
19GAFM,Plympton St.Mary                ,9616,5958,99,325,3658
19GAFN,Plymstock Dunstone              ,10622,6541,85,385,4081
19GAFP,Plymstock Radford               ,8673,4875,89,422,3798
19GAFQ,St.Budeaux                      ,8961,5058,109,625,3903
19GAFR,St.Peter                        ,9103,5185,189,1209,3918
19GAFS,Southway                        ,10352,6962,141,602,3390
19GAFT,Stoke                           ,10175,5899,151,827,4276
19GAFU,Sutton                          ,8665,4924,126,853,3741
19GAFW,Trelawny                        ,7903,4244,55,402,3659
19GASS,Shipping                        ,0,0,0,0,0
19GBFA,Avon and Harbourne              ,1548,940,7,64,608
19GBFB,Avonleigh                       ,1292,721,5,40,571
19GBFC,Bickleigh and Shaugh            ,3475,2542,22,133,933
19GBFD,Brixton                         ,1119,580,6,34,539
19GBFE,Charterlands                    ,1602,841,10,62,761
19GBFF,Cornwood and Harford            ,923,587,4,31,336
19GBFG,Dartington                      ,1321,717,11,68,604
19GBFH,Dartmouth Clifton               ,2485,1211,16,87,1274
19GBFJ,Dartmouth Hardness              ,2325,1271,20,96,1054
19GBFK,Dart Valley                     ,1490,877,18,60,613
19GBFL,Eastmoor                        ,972,532,8,35,440
19GBFM,Erme Valley                     ,1134,651,1,29,483
19GBFN,Garabrook                       ,1303,792,5,40,511
19GBFP,Ivybridge                       ,7170,4861,56,252,2309
19GBFQ,Kingsbridge                     ,4139,2142,15,145,1997
19GBFR,Kingswear                       ,1100,548,3,44,552
19GBFS,Malborough                      ,1273,572,3,27,701
19GBFT,Marldon                         ,1633,900,9,59,733
19GBFU,Modbury                         ,1133,627,3,32,506
19GBFW,Newton and Noss                 ,1496,720,6,46,776
19GBFX,Salcombe                        ,1922,903,7,48,1019
19GBFY,Saltstone                       ,1263,664,10,40,599
19GBFZ,Skerries                        ,1301,523,3,27,778
19GBGA,South Brent                     ,2240,1257,12,74,983
19GBGB,Sparkwell                       ,874,552,7,40,322
19GBGC,Stoke Gabriel                   ,1089,541,5,27,548
19GBGD,Stokenham                       ,1681,721,10,45,960
19GBGE,Thurlestone                     ,1520,665,4,39,855
19GBGF,Totnes                          ,3761,2070,33,220,1691
19GBGG,Totnes Bridgetown               ,2059,1019,17,103,1040
19GBGH,Ugborough                       ,1210,726,10,62,484
19GBGJ,Wembury                         ,2451,1434,30,60,1017
19GBGK,West Dart                       ,1317,703,4,45,614
19GBGL,Yealmpton                       ,1678,974,8,79,704
19GBSS,Shipping                        ,0,0,0,0,0
19GCFA,Abbotskerswell                  ,1219,696,9,34,523
19GCFB,Ambrook                         ,2815,1599,22,85,1216
19GCFC,Ashburton                       ,2991,1719,19,129,1272
19GCFD,Bovey                           ,4649,2475,29,147,2174
19GCFE,Bradley                         ,5341,3196,53,194,2145
19GCFF,Buckfastleigh                   ,2563,1417,30,96,1146
19GCFG,Buckland                        ,2928,1691,40,194,1237
19GCFH,Bushell                         ,3069,1822,28,150,1247
19GCFJ,Chudleigh                       ,3733,2308,29,163,1425
19GCFK,College                         ,4185,2346,40,172,1839
19GCFL,Dawlish Central                 ,4135,1946,24,141,2189
19GCFM,Dawlish North East              ,2589,1415,17,84,1174
19GCFN,Dawlish South West              ,3435,1624,27,130,1811
19GCFP,Dunsford                        ,994,586,3,30,408
19GCFQ,Haldon                          ,2268,1046,17,51,1222
19GCFR,Haytor                          ,1912,1114,13,56,798
19GCFS,Ipplepen                        ,1872,1030,7,45,842
19GCFT,Kenn Valley                     ,1790,1086,12,53,704
19GCFU,Kingskerswell                   ,3544,1880,32,105,1664
19GCFW,Kingsteignton East              ,4195,2570,24,144,1625
19GCFX,Kingsteignton West              ,3034,1757,29,85,1277
19GCFY,Milber                          ,2730,1578,11,79,1152
19GCFZ,Moorland                        ,1094,619,5,29,475
19GCGA,Moretonhampstead                ,1182,644,5,27,538
19GCGB,Powderham                       ,4088,2522,30,115,1566
19GCGC,Shaldon                         ,1400,599,2,60,801
19GCGD,Teignhydes                      ,1189,721,6,35,468
19GCGE,Teignmouth Central              ,2609,1293,14,117,1316
19GCGF,Teignmouth East                 ,2722,1193,11,127,1529
19GCGG,Teignmouth North                ,3004,1431,15,97,1573
19GCGH,Teignmouth West                 ,2786,1552,21,174,1234
19GCGJ,Teign Valley                    ,1455,848,9,36,607
19GCGK,Whitestone                      ,1711,887,6,48,824
19GCSS,Shipping                        ,0,0,0,0,0
19GDFA,Blatchcombe                     ,7794,4141,87,516,3653
19GDFB,Cockington-with-Chelston        ,8085,4503,62,363,3582
19GDFC,Coverdale                       ,8810,4712,113,579,4098
19GDFD,Ellacombe                       ,8309,4733,85,571,3576
19GDFE,Furzeham-with-Churston          ,7595,3369,69,317,4226
19GDFF,Preston                         ,8333,3883,73,327,4450
19GDFG,St.Marychurch                   ,8435,4097,46,403,4338
19GDFH,St.Micheal's-with-Goodrington   ,9417,4785,58,363,4632
19GDFJ,St.Peter's-with-St.Marys        ,8019,4027,75,442,3992
19GDFK,Shiphay                         ,8053,4614,68,430,3439
19GDFL,Tormohun                        ,8209,4873,74,718,3336
19GDFM,Torwood                         ,8276,4173,53,611,4103
19GDSS,Shipping                        ,0,0,0,0,0
19GEFA,Appledore East                  ,900,480,5,67,420
19GEFB,Appledore West                  ,910,448,7,27,462
19GEFC,Bideford East                   ,2928,1750,33,150,1178
19GEFD,Bideford North                  ,3649,2072,41,207,1577
19GEFE,Bideford South                  ,3823,2285,48,187,1538
19GEFF,Broadheath                      ,1123,676,5,27,447
19GEFG,Clovelly Bay                    ,1112,675,9,43,437
19GEFH,Coham Bridge                    ,1172,701,5,34,471
19GEFJ,Forest                          ,1261,719,20,34,542
19GEFK,Great Wood                      ,978,569,4,51,409
19GEFL,Hartland Point                  ,1309,730,12,57,579
19GEFM,Heanton                         ,1419,872,12,58,547
19GEFN,Holsworthy                      ,2239,1226,31,57,1013
19GEFP,Kenwith                         ,1263,767,7,47,496
19GEFQ,Melbury                         ,1332,826,13,65,506
19GEFR,Morice                          ,1259,767,17,36,492
19GEFS,Northam Central                 ,1323,595,11,44,728
19GEFT,Northam North                   ,1326,697,17,89,629
19GEFU,Northam West                    ,1252,507,9,65,745
19GEFW,Orchard Hill                    ,1041,515,9,33,526
19GEFX,Rolle                           ,1247,702,4,40,545
19GEFY,Stafford                        ,1010,582,11,35,428
19GEFZ,Tamarside                       ,1060,646,6,51,414
19GEGA,Torrington                      ,3610,2212,29,157,1398
19GEGB,Waldon                          ,1144,647,9,51,497
19GEGC,Westward Ho                     ,1330,659,30,95,671
19GEGD,Winkleigh                       ,1236,687,8,41,549
19GESS,Shipping                        ,0,0,0,0,0
19GFFA,Bere Ferrers                    ,2345,1338,26,104,1007
19GFFB,Bridestowe                      ,1208,712,11,41,496
19GFFC,Buckland Monachorum             ,2850,1528,15,74,1322
19GFFD,Burrator                        ,1278,695,2,58,583
19GFFE,Chagford                        ,1233,607,5,38,626
19GFFF,Courtenay                       ,1317,781,5,38,536
19GFFG,Drewsteignton                   ,1120,641,12,29,479
19GFFH,Exbourne                        ,840,450,8,30,390
19GFFJ,Hatherleigh                     ,1259,762,8,70,497
19GFFK,Lew Valley                      ,1081,651,10,42,430
19GFFL,Lydford                         ,1408,749,15,82,659
19GFFM,Mary Tavy                       ,1363,779,10,50,584
19GFFN,Milton Ford                     ,1076,676,6,44,400
19GFFP,North Tawton                    ,1230,697,6,43,533
19GFFQ,Okehampton                      ,3739,2202,31,126,1537
19GFFR,South Tawton                    ,943,539,9,36,404
19GFFS,Tamarside                       ,1167,702,6,50,465
19GFFT,Tavistock North                 ,3780,2195,16,160,1585
19GFFU,Tavistock South                 ,4613,2476,34,172,2137
19GFFW,Thrushel                        ,1203,709,8,56,494
19GFFX,Walkham                         ,2221,1386,16,103,835
19GFSS,Shipping                        ,0,0,0,0,0
20GGFA,Boscombe East                   ,6222,3539,38,448,2683
20GGFB,Boscombe West                   ,6728,3979,52,747,2749
20GGFC,Central                         ,6086,3106,16,428,2980
20GGFD,East Cliff                      ,6098,3271,46,476,2827
20GGFE,Ensbury Park                    ,6371,3512,19,287,2859
20GGFF,Kinson                          ,6580,3281,15,372,3299
20GGFG,Littledown                      ,8488,4868,35,325,3620
20GGFH,Moordown                        ,5870,3749,27,310,2121
20GGFJ,Muscliff                        ,7903,4823,28,309,3080
20GGFK,Queens Park                     ,7358,4154,34,408,3204
20GGFL,Redhill Park                    ,5843,3176,19,198,2667
20GGFM,Southbourne                     ,6720,2835,24,228,3885
20GGFN,Strouden Park                   ,8116,4511,24,360,3605
20GGFP,Talbot Woods                    ,5971,3244,17,291,2727
20GGFQ,Wallisdown                      ,6532,3430,23,560,3102
20GGFR,Westbourne                      ,6406,2794,24,307,3612
20GGFS,West Cliff                      ,6935,3816,34,570,3119
20GGFT,West Southbourne                ,7075,3502,17,372,3573
20GGFU,Winton                          ,6316,3753,27,291,2563
20GGSS,Shipping                        ,0,0,0,0,0
20GHFA,Burton                          ,3281,2020,15,94,1261
20GHFB,Chewton                         ,4001,1504,8,92,2497
20GHFC,Grange                          ,3905,2333,19,213,1572
20GHFD,Jumpers                         ,4127,2256,23,139,1871
20GHFE,Mudeford                        ,5018,2261,14,134,2757
20GHFF,Nea                             ,2642,822,7,60,1820
20GHFG,Portfield                       ,2679,1408,16,88,1271
20GHFH,St.Catherine's                  ,2771,1314,5,70,1457
20GHFJ,Twynham                         ,4019,2145,16,175,1874
20GHFK,Wingfield                       ,2510,1079,4,49,1431
20GHSS,Shipping                        ,0,0,0,0,0
20GJFA,Ameysford                       ,1952,1012,2,60,940
20GJFB,Colehill                        ,5854,3551,17,166,2303
20GJFC,Corfe Mullen Central            ,3673,2461,15,132,1212
20GJFD,Corfe Mullen North              ,1711,1116,5,49,595
20GJFE,Corfe Mullen South              ,2327,1354,8,68,973
20GJFF,Crane                           ,2895,1815,16,67,1080
20GJFG,Ferndown Central                ,2203,901,5,45,1302
20GJFH,Golf Links                      ,2028,784,6,45,1244
20GJFJ,Holt                            ,2039,1299,9,79,740
20GJFK,Longham                         ,1716,1153,4,58,563
20GJFL,St.Leonards and St.Ives East    ,2934,1248,3,79,1686
20GJFM,St.Leonards and St.Ives South   ,0,0,0,0,0
20GJFN,St.Leonards and St.Ives West    ,2858,1223,10,99,1635
20GJFP,Sixpenny Handley                ,1271,750,4,34,521
20GJFQ,Stapehill                       ,1574,893,9,50,681
20GJFR,Sturminster Marshall            ,1319,806,4,44,513
20GJFS,Tricketts Cross                 ,4359,2270,22,236,2089
20GJFT,Vale Of Allen                   ,1216,754,8,44,462
20GJFU,Verwood                         ,8444,4497,21,244,3947
20GJFW,West Moors North                ,3038,1281,6,59,1757
20GJFX,West Moors South                ,2895,1336,7,122,1559
20GJFY,West Parley                     ,3035,1511,7,75,1524
20GJFZ,Wimborne Minster                ,5807,3118,9,200,2689
20GJSS,Shipping                        ,0,0,0,0,0
20GKFA,Abbey                           ,2208,1295,7,65,913
20GKFB,Blackmore                       ,2533,1443,14,73,1090
20GKFC,Blandford East                  ,2748,1648,19,86,1100
20GKFD,Blandford West                  ,3601,2386,12,112,1215
20GKFE,Bourton and District            ,1243,652,4,32,591
20GKFF,Bulbarrow                       ,858,515,0,27,343
20GKFG,Cranborne Chase                 ,1338,757,4,37,581
20GKFH,Gillingham Town                 ,1345,833,0,58,512
20GKFJ,Hill Forts                      ,2440,1380,9,59,1060
20GKFK,Hills and Vale                  ,1245,685,5,34,560
20GKFL,Lodbourne                       ,1188,594,4,30,594
20GKFM,Lower Winterborne               ,1081,651,7,29,430
20GKFN,Lydden Vale                     ,995,533,1,32,462
20GKFP,Marnhull                        ,1567,693,5,42,874
20GKFQ,Milton                          ,1040,491,4,26,549
20GKFR,Motcombe                        ,1224,696,8,39,528
20GKFS,Portman                         ,1239,796,12,56,443
20GKFT,Riversdale                      ,1241,744,0,41,497
20GKFU,Shaftesbury Central             ,1138,607,1,44,531
20GKFW,Shaftesbury Christy's           ,1421,815,5,37,606
20GKFX,Shaftesbury Grosvenor           ,1568,1066,4,38,502
20GKFY,Shaftesbury Underhill           ,883,450,2,27,433
20GKFZ,Stour Valley                    ,2497,1379,4,61,1118
20GKGA,The Beacon                      ,993,548,6,26,445
20GKGB,The Lower Tarrants              ,1790,1322,12,56,468
20GKGC,The Stours                      ,1074,605,11,24,469
20GKGD,Wyke                            ,1699,785,7,24,914
20GKSS,Shipping                        ,0,0,0,0,0
20GLFA,Alderney                        ,8516,5206,70,537,3310
20GLFB,Bourne Valley                   ,9314,5809,48,514,3505
20GLFC,Broadstone                      ,7680,4235,16,216,3445
20GLFD,Canford Cliffs                  ,6930,2439,7,168,4491
20GLFE,Canford Heath                   ,10126,7409,44,468,2717
20GLFF,Canford Magna                   ,8303,5336,25,263,2967
20GLFG,Creekmoor                       ,7472,5028,18,353,2444
20GLFH,Hamworthy                       ,9469,6172,64,645,3297
20GLFJ,Harbour                         ,8395,4576,26,449,3819
20GLFK,Newtown                         ,8722,5277,47,541,3445
20GLFL,Oakdale                         ,7917,4708,36,327,3209
20GLFM,Parkstone                       ,7881,4062,18,319,3819
20GLFN,Penn Hill                       ,8096,4492,27,345,3604
20GLSS,Shipping                        ,0,0,0,0,0
20GMFA,Bere Regis                      ,1839,1184,5,74,655
20GMFB,Castle                          ,2507,1330,4,81,1177
20GMFC,Langton                         ,1250,624,7,24,626
20GMFD,Lytchett Matravers              ,2236,1339,3,98,897
20GMFE,Lytchett Minster                ,5930,3901,14,281,2029
20GMFF,St.Martin                       ,2071,1217,6,84,854
20GMFG,Swanage North                   ,3129,1238,11,71,1891
20GMFH,Swanage South                   ,4427,2343,18,209,2084
20GMFJ,Wareham                         ,4751,2770,9,177,1981
20GMFK,West Purbeck                    ,1309,858,9,49,451
20GMFL,Winfrith                        ,1338,792,6,34,546
20GMFM,Wool                            ,3865,2501,40,128,1364
20GMSS,Shipping                        ,0,0,0,0,0
20GNFA,Beaminster                      ,3079,1612,19,102,1467
20GNFB,Bothenhampton                   ,1576,615,12,41,961
20GNFC,Bradford Abbas                  ,1474,899,10,38,575
20GNFD,Bradpole                        ,1742,814,4,52,928
20GNFE,Bridport North                  ,3331,1792,16,123,1539
20GNFF,Bridport South                  ,2715,1403,12,120,1312
20GNFG,Broadmayne                      ,1478,861,6,29,617
20GNFH,Broadwindsor                    ,1131,573,8,32,558
20GNFJ,Burton Bradstock                ,1273,548,6,39,725
20GNFK,Caundle Vale                    ,1084,618,7,29,466
20GNFL,Cerne Valley                    ,1138,627,4,32,511
20GNFM,Charminster                     ,1353,692,3,44,661
20GNFN,Charmouth                       ,1305,573,2,36,732
20GNFP,Chesil Bank                     ,1361,812,10,42,549
20GNFQ,Chickerell                      ,3459,2162,32,133,1297
20GNFR,Dorchester East                 ,2722,1681,8,112,1041
20GNFS,Dorchester North                ,2241,1288,7,77,953
20GNFT,Dorchester South                ,4028,2400,22,102,1628
20GNFU,Dorchester West                 ,3289,1974,16,134,1315
20GNFW,Frome Valley                    ,1175,676,8,29,499
20GNFX,Halstock                        ,1240,710,15,33,530
20GNFY,Holnest                         ,1304,723,6,45,581
20GNFZ,Loders                          ,1096,537,11,32,559
20GNGA,Lyme Regis                      ,3083,1426,13,123,1657
20GNGB,Maiden Newton                   ,1229,734,5,31,495
20GNGC,Netherbury                      ,1275,716,5,40,559
20GNGD,Owermoigne                      ,2486,1455,13,85,1031
20GNGE,Piddle Valley                   ,1433,874,10,49,559
20GNGF,Puddletown                      ,2051,1268,14,63,783
20GNGG,Queen Thorne                    ,1162,634,6,27,528
20GNGH,Sherborne East                  ,2575,1171,11,73,1404
20GNGJ,Sherborne West                  ,3854,1965,12,123,1889
20GNGK,Symondsbury                     ,1417,811,7,52,606
20GNGL,Thorncombe                      ,1018,586,8,36,432
20GNGM,Tolpuddle                       ,0,0,0,0,0
20GNGN,Whitechurch Canonicorum         ,1197,532,5,34,665
20GNGP,Winterborne St. Martin          ,1949,1192,11,55,757
20GNGQ,Yetminster                      ,1363,729,12,50,634
20GNSS,Shipping                        ,0,0,0,0,0
20GPFA,Melcombe Regis                  ,3903,2496,53,414,1407
20GPFB,North                           ,2732,1584,19,114,1148
20GPFC,North Central                   ,5051,3077,33,284,1974
20GPFD,Preston                         ,4258,2099,18,99,2159
20GPFE,Radipole                        ,3230,1728,10,103,1502
20GPFF,Tophill East                    ,2720,1634,26,166,1086
20GPFG,Tophill West                    ,4164,2870,63,179,1294
20GPFH,Underhill                       ,3236,2013,74,222,1223
20GPFJ,Westham East                    ,2939,1832,32,209,1107
20GPFK,Westham North                   ,4131,2307,30,191,1824
20GPFL,Westham West                    ,2532,1393,31,96,1139
20GPFM,Weymouth East                   ,2560,1384,24,141,1176
20GPFN,Weymouth West                   ,4005,2278,37,207,1727
20GPFP,Wyke Regis                      ,4088,2531,49,176,1557
20GPSS,Shipping                        ,0,0,0,0,0
21GQFA,Bournmoor                       ,2675,1657,38,130,1018
21GQFB,Chester Central                 ,1364,917,15,71,447
21GQFC,Chester North                   ,3297,1957,40,142,1340
21GQFD,Chester South                   ,3346,1845,35,165,1501
21GQFE,Chester West                    ,3463,1725,86,290,1738
21GQFF,Edmondsley                      ,0,0,0,0,0
21GQFG,Grange Villa                    ,1447,860,35,134,587
21GQFH,Holmlands Park                  ,2912,1743,27,83,1169
21GQFJ,Lumley                          ,3442,2125,47,187,1317
21GQFK,North Lodge                     ,2006,1345,8,74,661
21GQFL,Ouston                          ,2606,1791,39,133,815
21GQFM,Pelton                          ,3897,2401,48,270,1496
21GQFN,Pelton Fell                     ,2026,1130,36,196,896
21GQFP,Plawsworth                      ,1214,722,26,100,492
21GQFQ,Sacriston                       ,3664,2224,79,257,1440
21GQFR,Urpeth                          ,2983,2244,23,115,739
21GQFS,Waldridge                       ,1969,1504,12,51,465
21GQSS,Shipping                        ,0,0,0,0,0
21GRFA,Bank Top                        ,2944,1908,47,192,1036
21GRFB,Central                         ,2449,1442,52,246,1007
21GRFC,Cockerton East                  ,4612,2701,72,278,1911
21GRFD,Cockerton West                  ,2551,1264,42,198,1287
21GRFE,College                         ,2728,1536,32,119,1192
21GRFF,Eastbourne North                ,2282,1285,47,230,997
21GRFG,Eastbourne South                ,2713,1508,82,287,1205
21GRFH,Harrowgate Hill                 ,4430,2924,64,231,1506
21GRFJ,Haughton East                   ,6304,3906,100,365,2398
21GRFK,Haughton West                   ,3722,2354,46,240,1368
21GRFL,Heighington                     ,1746,946,12,39,800
21GRFM,Hummersknott                    ,3444,1862,16,88,1582
21GRFN,Hurworth                        ,2985,1785,17,122,1200
21GRFP,Lascelles                       ,2802,1671,52,229,1131
21GRFQ,Lingfield                       ,3344,1938,35,199,1406
21GRFR,Middleton St.George             ,2677,1432,14,84,1245
21GRFS,Mowden                          ,3379,1957,23,83,1422
21GRFT,Northgate North                 ,3104,1956,68,329,1148
21GRFU,Northgate South                 ,2752,1766,65,252,986
21GRFW,North Road                      ,3266,2090,54,216,1176
21GRFX,Park East                       ,4189,2486,107,450,1703
21GRFY,Park West                       ,2916,1485,16,80,1431
21GRFZ,Pierremont                      ,4667,2938,65,235,1729
21GRGA,Sadberge                        ,1236,803,7,46,433
21GRGB,Whessoe                         ,1804,1126,15,63,678
21GRSS,Shipping                        ,0,0,0,0,0
21GSFA,Annfield Plain                  ,3270,1647,58,187,1623
21GSFB,Benfieldside                    ,4515,2777,52,182,1738
21GSFC,Blackhill                       ,3501,1992,67,260,1509
21GSFD,Burnhope                        ,945,468,36,81,477
21GSFE,Burnopfield                     ,4058,2477,43,187,1581
21GSFF,Castleside                      ,1235,764,17,40,471
21GSFG,Catchgate                       ,2311,1290,64,193,1021
21GSFH,Consett North                   ,2500,1405,27,140,1095
21GSFJ,Consett South                   ,3259,1665,76,323,1594
21GSFK,Cornsay                         ,1210,672,24,75,538
21GSFL,Craghead                        ,2313,1188,57,224,1125
21GSFM,Crookhall                       ,1555,991,35,104,564
21GSFN,Delves Lane                     ,3576,2015,62,279,1561
21GSFP,Dipton                          ,2284,1251,66,183,1033
21GSFQ,Ebchester and Medomsley         ,3828,2117,48,251,1711
21GSFR,Esh                             ,3479,1919,57,241,1560
21GSFS,Havannah                        ,4607,2657,69,305,1950
21GSFT,Lanchester                      ,4080,2300,51,118,1780
21GSFU,Leadgate                        ,3414,1813,57,232,1601
21GSFW,South Moor                      ,3247,1851,62,231,1396
21GSFX,South Stanley                   ,3648,1802,86,303,1846
21GSFY,Stanley Hall                    ,3310,1772,71,259,1538
21GSFZ,Tanfield                        ,3385,2156,74,182,1229
21GSSS,Shipping                        ,0,0,0,0,0
21GTFA,Bearpark                        ,1489,826,23,107,663
21GTFB,Belmont                         ,3079,2083,29,79,996
21GTFC,Brandon                         ,4801,2813,61,303,1988
21GTFD,Carrville                       ,2444,1475,19,88,969
21GTFE,Cassop-cum-Quarrington          ,3664,2128,44,195,1536
21GTFF,Coxhoe                          ,3942,2170,60,239,1772
21GTFG,Croxdale                        ,1102,695,13,53,407
21GTFH,Deerness                        ,2848,1604,34,217,1244
21GTFJ,Elvet                           ,2069,886,14,71,1183
21GTFK,Framwelgate                     ,3989,2367,37,146,1622
21GTFL,Framwellgate Moor               ,3120,1753,49,149,1367
21GTFM,Gilesgate                       ,3175,1681,29,208,1494
21GTFN,Gilesgate Moor                  ,2535,1658,27,118,877
21GTFP,Langley Moor and Meadowfield    ,2479,1670,26,121,809
21GTFQ,Neville's Cross                 ,3459,2049,15,109,1410
21GTFR,New Brancepeth                  ,1027,586,29,84,441
21GTFS,Newton Hall                     ,4153,2874,41,119,1279
21GTFT,Pelaw                           ,1939,996,46,269,943
21GTFU,Pittington and West Rainton     ,2977,1816,44,209,1161
21GTFW,Shadforth                       ,1116,600,13,90,516
21GTFX,Sherburn                        ,2598,1463,17,150,1135
21GTFY,Shincliffe                      ,1375,820,0,34,555
21GTFZ,Ushaw Moor                      ,3316,2075,66,220,1241
21GTGA,Witton Gilbert                  ,2206,1265,39,110,941
21GTSS,Shipping                        ,0,0,0,0,0
21GUFA,Acre Rigg                       ,2840,1536,56,158,1304
21GUFB,Blackhalls                      ,5031,2380,81,257,2651
21GUFC,Dawdon                          ,4363,2373,138,466,1990
21GUFD,Deaf Hill                       ,1151,577,23,85,574
21GUFE,Dene House                      ,3200,1726,75,225,1474
21GUFF,Deneside                        ,3380,1263,91,340,2117
21GUFG,Easington Colliery              ,4434,2218,67,241,2216
21GUFH,Easington Village               ,2078,1184,30,67,894
21GUFJ,Eden Hill                       ,4024,2076,112,404,1948
21GUFK,Haswell                         ,1405,717,18,109,688
21GUFL,High Colliery                   ,1374,695,34,129,679
21GUFM,Horden North                    ,4117,1842,76,270,2275
21GUFN,Horden South                    ,2909,1454,60,258,1455
21GUFP,Howletch                        ,2936,1789,56,199,1147
21GUFQ,Hutton Henry                    ,1511,793,19,84,718
21GUFR,Murton East                     ,5763,3417,92,335,2346
21GUFS,Murton West                     ,2813,1364,33,176,1449
21GUFT,Park                            ,1648,909,29,85,739
21GUFU,Passfield                       ,3722,2443,84,196,1279
21GUFW,Seaham                          ,3448,1689,38,170,1759
21GUFX,Shotton                         ,3417,1496,54,202,1921
21GUFY,South                           ,1218,659,20,103,559
21GUFZ,South Hetton                    ,2194,1104,34,156,1090
21GUGA,Thornley                        ,2351,1128,44,167,1223
21GUGB,Wheatley Hill                   ,2890,1399,51,207,1491
21GUGC,Wingate                         ,2920,1490,51,158,1430
21GUSS,Shipping                        ,0,0,0,0,0
21GWFA,Bishop Middleham                ,1063,665,11,38,398
21GWFB,Broom                           ,4290,2306,83,259,1984
21GWFC,Byerley                         ,2750,1480,30,151,1270
21GWFD,Chilton                         ,4604,2839,81,308,1765
21GWFE,Cornforth                       ,2221,1093,26,148,1128
21GWFF,Ferryhill                       ,3980,2279,82,222,1701
21GWFG,Fishburn                        ,1832,1021,30,98,811
21GWFH,Low Spennymoor and Tudhoe Grange,3704,2052,63,251,1652
21GWFJ,Middlestone                     ,3824,2235,66,220,1589
21GWFK,Middridge                       ,3558,2368,53,226,1190
21GWFL,Neville                         ,2375,1320,36,124,1055
21GWFM,New Trimdon and Trimdon Grange  ,1466,831,21,73,635
21GWFN,Old Trimdon                     ,2439,1302,68,143,1137
21GWFP,Sedgefield                      ,4802,2653,44,131,2149
21GWFQ,Shafto                          ,2097,1261,25,121,836
21GWFR,Simpasture                      ,1521,851,13,80,670
21GWFS,Spennymoor                      ,5059,3386,50,277,1673
21GWFT,Sunnydale                       ,2581,1449,37,196,1132
21GWFU,Thickley                        ,3935,2229,90,398,1706
21GWFW,Tudhoe                          ,2838,1650,47,185,1188
21GWFX,West                            ,4574,2777,94,378,1797
21GWFY,Woodham                         ,6160,4036,77,310,2124
21GWSS,SHIPPING                        ,0,0,0,0,0
21GXFA,Barnard Castle East             ,1876,1047,13,68,829
21GXFB,Barnard Castle West             ,2116,1205,19,73,911
21GXFC,Cockfield                       ,1392,748,19,87,644
21GXFD,Cotherstone with Lartington     ,0,0,0,0,0
21GXFE,Eggleston                       ,0,0,0,0,0
21GXFF,Etherley                        ,1576,915,16,66,661
21GXFG,Evebwood with Ramshaw           ,1783,1003,35,132,780
21GXFH,Gainford and Winston            ,1432,835,13,42,597
21GXFJ,Greta                           ,0,0,0,0,0
21GXFK,Hamsterley and South Bedburn    ,1288,753,13,23,535
21GXFL,Ingleton                        ,0,0,0,0,0
21GXFM,Lynesack                        ,1743,1043,16,71,700
21GXFN,Middleton-in-Teesdale           ,1229,682,12,43,547
21GXFP,Romaldkirk                      ,1237,736,12,37,501
21GXFQ,Staindrop                       ,1742,1034,16,46,708
21GXFR,Startforth East                 ,1048,671,10,25,377
21GXFS,Startforth with Boldron         ,1398,856,11,31,542
21GXFT,Streatlam with Whorlton         ,0,0,0,0,0
21GXFU,Toft Hill and Lands             ,0,0,0,0,0
21GXSS,Shipping                        ,0,0,0,0,0
21GYFA,Bishop Auckland Town            ,3315,1948,43,157,1367
21GYFB,Cockton Hill                    ,4188,2606,43,149,1582
21GYFC,Coundon                         ,3692,2130,75,253,1562
21GYFD,Coundon Grange                  ,1748,1004,32,172,744
21GYFE,Crook North                     ,1356,753,9,80,603
21GYFF,Crook South                     ,3773,2213,45,272,1560
21GYFG,Escomb                          ,1791,1212,14,94,579
21GYFH,Henknowle                       ,2174,1072,27,150,1102
21GYFJ,Howden                          ,1720,957,22,85,763
21GYFK,Hunwick                         ,1232,735,16,61,497
21GYFL,St.Helen's                      ,1931,1052,58,172,879
21GYFM,St. John's Chapel               ,1203,682,9,104,521
21GYFN,Stanhope                        ,2086,1148,27,107,938
21GYFP,Stanley                         ,1391,791,21,102,600
21GYFQ,Tow Law                         ,1739,886,22,154,853
21GYFR,West Auckland                   ,2279,1271,31,108,1008
21GYFS,Wheatbottom and Helmington Row  ,2539,1238,38,174,1301
21GYFT,Willington East                 ,2993,1485,38,189,1508
21GYFU,Willington West                 ,2438,1367,56,207,1071
21GYFW,Wolsingham                      ,2808,1586,41,133,1222
21GYFX,Woodhouse Close                 ,4069,2071,108,401,1998
21GYSS,Shipping                        ,0,0,0,0,0
22GZFA,Hanover                         ,8496,5259,73,686,3237
22GZFB,Hollingbury                     ,7590,4582,47,445,3008
22GZFC,King's Cliff                    ,6904,4030,61,542,2874
22GZFD,Marine                          ,8282,4554,58,772,3728
22GZFE,Moulsecoomb                     ,7076,4304,88,682,2772
22GZFF,Patcham                         ,7237,4211,18,205,3026
22GZFG,Preston                         ,7951,4684,25,333,3267
22GZFH,Queen's Park                    ,6692,3731,46,664,2961
22GZFJ,Regency                         ,7277,4736,64,845,2541
22GZFK,Rottingdean                     ,7719,3914,28,258,3805
22GZFL,St.Peter's                      ,7710,5050,58,585,2660
22GZFM,Seven Dials                     ,7827,5230,53,736,2597
22GZFN,Stanmer                         ,6413,3597,42,263,2816
22GZFP,Tenantry                        ,7395,4864,33,481,2531
22GZFQ,Westdene                        ,7424,4523,20,307,2901
22GZFR,Woodingdean                     ,7786,4977,55,357,2809
22GZSS,Shipping                        ,0,0,0,0,0
22HAFA,Devonshire                      ,6234,3562,40,480,2672
22HAFB,Downside                        ,6286,3536,25,273,2750
22HAFC,Hampden Park                    ,6480,3812,33,250,2668
22HAFD,Langney                         ,9743,5543,75,487,4200
22HAFE,Meads                           ,6500,2185,21,176,4315
22HAFF,Ocklynge                        ,5621,3036,20,161,2585
22HAFG,Ratton                          ,6463,3521,33,288,2942
22HAFH,Roselands                       ,6907,3865,27,276,3042
22HAFJ,St.Anthony's                    ,6805,3492,31,290,3313
22HAFK,Upperton                        ,7268,2978,25,262,4290
22HASS,Shipping                        ,0,0,0,0,0
22HBFA,Ashdown                         ,5049,3142,27,196,1907
22HBFB,Braybrooke                      ,4277,2491,36,311,1786
22HBFC,Broomgrove                      ,3443,1871,32,245,1572
22HBFD,Castle                          ,3109,1896,41,315,1213
22HBFE,Central St.Leonards             ,3879,2131,53,381,1748
22HBFF,Elphinstone                     ,3890,2236,19,163,1654
22HBFG,Gensing                         ,4144,2267,32,271,1877
22HBFH,Hollington                      ,4187,2399,49,290,1788
22HBFJ,Maze Hill                       ,3753,1701,18,219,2052
22HBFK,Mount Pleasant                  ,4208,2444,25,249,1764
22HBFL,Old Hastings                    ,3314,1863,22,192,1451
22HBFM,Ore                             ,3985,2320,38,221,1665
22HBFN,St.Helens                       ,4191,2227,35,115,1964
22HBFP,Silverhill                      ,3998,2331,28,209,1667
22HBFQ,West St.Leonards                ,5037,2929,23,236,2108
22HBFR,Wishing Tree                    ,4470,2529,22,231,1941
22HBSS,Shipping                        ,0,0,0,0,0
22HCFA,Brunswick and Adelaide          ,7807,4720,48,724,3087
22HCFB,Goldsmid                        ,7709,3916,40,436,3793
22HCFC,Hangleton                       ,6817,3895,31,273,2922
22HCFD,Nevill                          ,6656,3852,26,332,2804
22HCFE,Portslade North                 ,6941,4811,40,315,2130
22HCFF,Portslade South                 ,7274,4366,37,329,2908
22HCFG,Stanford                        ,6889,3720,30,212,3169
22HCFH,Vallance                        ,7594,4241,42,552,3353
22HCFJ,Westbourne                      ,7592,3700,30,356,3892
22HCFK,Wish                            ,7109,3786,41,321,3323
22HCSS,Shipping                        ,0,0,0,0,0
22HDFA,Barcombe                        ,1784,1117,7,37,667
22HDFB,Chailey                         ,1985,1267,4,62,718
22HDFC,Ditchling                       ,1552,700,1,30,852
22HDFD,East Saltdean                   ,2348,1123,7,69,1225
22HDFE,Hamsey                          ,0,0,0,0,0
22HDFF,Kingston                        ,1610,958,7,40,652
22HDFG,Lewes Bridge                    ,3953,2681,16,178,1272
22HDFH,Lewes Castle                    ,3873,2387,21,198,1486
22HDFJ,Lewes Priory                    ,4605,2722,10,169,1883
22HDFK,Newhaven Denton                 ,2510,1684,3,96,826
22HDFL,Newhaven Meeching               ,3065,1873,11,164,1192
22HDFM,Newhaven Valley                 ,2651,1689,18,102,962
22HDFN,Newick                          ,1916,1168,4,62,748
22HDFP,Ouse Valley                     ,1402,845,4,52,557
22HDFQ,Peacehaven East                 ,2404,1262,7,119,1142
22HDFR,Peacehaven North                ,5522,3371,24,238,2151
22HDFS,Peacehaven West                 ,2641,1200,10,92,1441
22HDFT,Plumpton                        ,1465,1004,2,54,461
22HDFU,Ringmer                         ,3684,2164,19,104,1520
22HDFW,Seaford Central                 ,4256,1940,6,138,2316
22HDFX,Seaford East                    ,4317,1975,2,113,2342
22HDFY,Seaford North                   ,5136,2750,18,161,2386
22HDFZ,Seaford West                    ,4142,1619,4,70,2523
22HDGA,Telscombe Cliffs                ,3192,1946,9,112,1246
22HDGB,Wivelsfield                     ,1477,966,4,42,511
22HDSS,Shipping                        ,0,0,0,0,0
22HEFA,Ashburnham                      ,1221,708,4,33,513
22HEFB,Battle                          ,4736,2450,17,148,2286
22HEFC,Beckley and Peasmarsh           ,1591,880,2,49,711
22HEFD,Bodian and Ewhurst              ,1064,644,2,32,420
22HEFE,Brede and Udimore               ,1714,868,5,63,846
22HEFF,Burwash                         ,2047,1175,13,66,872
22HEFG,Camber                          ,1778,1060,5,102,718
22HEFH,Catsfield and Crowhurst         ,1347,744,8,39,603
22HEFJ,Central                         ,4423,1945,17,206,2478
22HEFK,Collington                      ,4302,1509,12,95,2793
22HEFL,Etchingham and Hurst Green      ,1631,1030,4,57,601
22HEFM,Fairlight                       ,1418,510,2,30,908
22HEFN,Guestling and Pett              ,1790,1021,4,51,769
22HEFP,Northiam                        ,1504,762,1,65,742
22HEFQ,Old Town                        ,3390,1768,17,124,1622
22HEFR,Rye                             ,3503,1922,10,189,1581
22HEFS,Sackville                       ,3456,975,6,89,2481
22HEFT,St.Marks                        ,4674,1597,11,97,3077
22HEFU,St.Michaels                     ,4565,1981,20,144,2584
22HEFW,St.Stephens                     ,4589,1779,10,104,2810
22HEFX,Salehurst                       ,1708,877,4,62,831
22HEFY,Sedlescombe and Whatlington     ,1287,715,5,34,572
22HEFZ,Sidley                          ,4120,2192,21,183,1928
22HEGA,Ticehurst                       ,2543,1527,0,69,1016
22HEGB,Westfield                       ,2014,1111,14,51,903
22HEGC,Winchelsea                      ,2090,1056,8,101,1034
22HESS,Shipping                        ,0,0,0,0,0
22HFFA,Alfriston                       ,1439,778,4,35,661
22HFFB,Arlington                       ,1641,807,4,33,834
22HFFC,Buxted                          ,3032,1758,5,83,1274
22HFFD,Chiddingly and East Hoathly     ,1635,1005,7,33,630
22HFFE,Crowborough East                ,4992,3485,12,157,1507
22HFFF,Crowborough North               ,4432,2918,11,102,1514
22HFFG,Crowborough St Johns            ,1641,900,4,38,741
22HFFH,Crowborough West                ,4064,2333,13,97,1731
22HFFJ,Danehill                        ,1546,913,5,39,633
22HFFK,East Dean                       ,1538,632,4,17,906
22HFFL,Fletching                       ,1390,857,4,45,533
22HFFM,Forest Row                      ,3765,2263,7,120,1502
22HFFN,Framfield                       ,1435,866,3,46,569
22HFFP,Frant                           ,1152,658,6,27,494
22HFFQ,Hailsham Central and North      ,3627,2036,17,89,1591
22HFFR,Hailsham East                   ,3952,2217,14,227,1735
22HFFS,Hailsham South and West         ,4286,2303,19,142,1983
22HFFT,Hartfield                       ,1628,971,2,49,657
22HFFU,Heathfield                      ,5068,3049,13,142,2019
22HFFW,Hellingly                       ,3678,2243,15,92,1435
22HFFX,Herstmonceux                    ,3264,1829,9,83,1435
22HFFY,Horam                           ,1957,1166,11,49,791
22HFFZ,Maresfield                      ,2543,1441,2,97,1102
22HFGA,Mayfield                        ,2813,1620,12,81,1193
22HFGB,Ninfield                        ,1478,846,3,61,632
22HFGC,Pevensey and Westham            ,4994,2345,17,120,2649
22HFGD,Polegate North                  ,3557,1492,10,98,2065
22HFGE,Polegate South                  ,3159,1251,6,80,1908
22HFGF,Rotherfield                     ,2531,1504,7,84,1027
22HFGG,Uckfield                        ,9286,6157,21,280,3129
22HFGH,Wadhurst                        ,3623,2112,11,107,1511
22HFGJ,Waldron                         ,3496,1879,11,102,1617
22HFGK,Willingdon                      ,5119,2247,11,98,2872
22HFGL,Withyham                        ,2066,1249,4,57,817
22HFSS,Shipping                        ,0,0,0,0,0
23HGFA,Billericay East                 ,8941,5785,24,269,3156
23HGFB,Billericay West                 ,9873,6582,27,279,3291
23HGFC,Burstead                        ,8632,5305,27,316,3327
23HGFD,Fryerns Central                 ,8632,5197,39,518,3435
23HGFE,Fryerns East                    ,8393,5227,59,737,3166
23HGFF,Laindon                         ,9106,5948,52,527,3158
23HGFG,Langdon Hills                   ,9305,6468,55,750,2837
23HGFH,Lee Chapel North                ,7950,5001,42,475,2949
23HGFJ,Nethermayne                     ,7633,5022,27,374,2611
23HGFK,Pitsea East                     ,11106,7536,77,793,3570
23HGFL,Pitsea West                     ,9074,5547,43,647,3527
23HGFM,Vange                           ,8041,5015,67,639,3026
23HGFN,Wickford North                  ,9493,6097,35,415,3396
23HGFP,Wickford South                  ,9478,6099,32,396,3379
23HGSS,Shipping                        ,0,0,0,0,0
23HHFA,Black Notley                    ,2368,1688,14,77,680
23HHFB,Bocking North                   ,4443,2720,22,178,1723
23HHFC,Bocking South                   ,4584,2673,29,239,1911
23HHFD,Braintree Central               ,5007,3361,19,295,1646
23HHFE,Braintree East                  ,5575,3892,15,295,1683
23HHFF,Braintree West                  ,4891,3178,14,202,1713
23HHFG,Bumpstead                       ,1745,1159,9,29,586
23HHFH,Castle Hedingham                ,1377,846,6,54,531
23HHFJ,Coggeshall                      ,4206,2563,19,157,1643
23HHFK,Colne Engaine and Greenstead Gre,1211,783,3,38,428
23HHFL,Cressing                        ,1282,788,5,71,494
23HHFM,Earls Colne                     ,3003,1745,5,125,1258
23HHFN,Gosfield                        ,1093,617,2,21,476
23HHFP,Halstead St.Andrews             ,3800,2369,19,146,1431
23HHFQ,Halstead Trinity                ,3956,2579,27,205,1377
23HHFR,Hatfield Peverel                ,3536,2236,13,109,1300
23HHFS,Kelvedon                        ,3852,2422,24,117,1430
23HHFT,Panfield                        ,1372,855,5,66,517
23HHFU,Rayne                           ,1959,1370,4,73,589
23HHFW,Sible Hedingham                 ,2824,1815,12,138,1009
23HHFX,Stour Valley Central            ,1277,793,2,43,484
23HHFY,Stour Valley North              ,1132,704,2,50,428
23HHFZ,Stour Valley South              ,1618,997,1,61,621
23HHGA,Terling                         ,1241,813,6,36,428
23HHGB,Three Fields                    ,2811,1715,14,112,1096
23HHGC,Upper Colne                     ,1323,778,7,43,545
23HHGD,Witham Central                  ,2167,1207,8,72,960
23HHGE,Witham Chipping Hill            ,3449,2296,23,190,1153
23HHGF,Witham North                    ,4052,2979,24,242,1073
23HHGG,Witham Silver End and Rivenhall ,3154,2097,19,164,1057
23HHGH,Witham South                    ,4971,3246,20,260,1725
23HHGJ,Witham West                     ,3046,1985,12,172,1061
23HHGK,Yeldham                         ,1432,888,4,66,544
23HHSS,Shipping                        ,0,0,0,0,0
23HJFA,Blackmore                       ,934,637,0,42,297
23HJFB,Brentwood North                 ,4815,3028,28,178,1787
23HJFC,Brentwood South                 ,4315,2316,11,165,1999
23HJFD,Brentwood West                  ,4122,2742,21,152,1380
23HJFE,Brizes and Doddinghurst         ,5182,3449,20,199,1733
23HJFF,Herongate and Ingrave           ,1710,1099,7,57,611
23HJFG,Hook End and Wyatts Green       ,1674,1098,5,42,576
23HJFH,Hutton East                     ,3823,2250,7,124,1573
23HJFJ,Hutton North                    ,3360,1942,8,129,1418
23HJFK,Hutton South                    ,5432,3449,9,134,1983
23HJFL,Ingatestone and Fryerning       ,4068,2436,37,123,1632
23HJFM,Mountnessing                    ,997,620,0,40,377
23HJFN,Pilgrims Hatch                  ,5309,3397,25,205,1912
23HJFP,Shenfield                       ,4465,2644,8,99,1821
23HJFQ,South Weald                     ,1150,780,0,39,370
23HJFR,Warley                          ,5393,3326,32,178,2067
23HJFS,West Horndon                    ,1195,699,1,39,496
23HJSS,Shipping                        ,0,0,0,0,0
23HKFA,Appleton                        ,5528,3552,33,196,1976
23HKFB,Boyce                           ,5056,3186,20,150,1870
23HKFC,Canvey Island Central           ,4471,2463,36,272,2008
23HKFD,Canvey Island East              ,5478,3432,25,289,2046
23HKFE,Canvey Island North             ,5678,3525,37,334,2153
23HKFF,Canvey Island South             ,3599,2184,17,246,1415
23HKFG,Canvey Island West              ,4025,2526,19,245,1499
23HKFH,Canvey Island Winter Gardens    ,5274,3746,52,372,1528
23HKFJ,Cedar Hall                      ,4728,2874,32,202,1854
23HKFK,St.George's                     ,5797,4264,37,260,1533
23HKFL,St.James                        ,4577,2413,14,146,2164
23HKFM,St.Mary's                       ,4941,3025,39,193,1916
23HKFN,St.Peter's                      ,5250,3452,26,213,1798
23HKFP,Victoria                        ,4669,2787,20,133,1882
23HKSS,Shipping                        ,0,0,0,0,0
23HLFA,All Saints                      ,4246,2560,18,312,1686
23HLFB,Baddow Road and Great Baddow Vil,6305,4005,17,212,2300
23HLFC,Boreham                         ,2525,1692,8,70,833
23HLFD,BroomfieldPleshey and Great Wal ,4997,3192,23,157,1805
23HLFE,Cathedral                       ,4456,2789,13,182,1667
23HLFF,ChignallGood EasterMashbury Hi  ,2060,1336,8,67,724
23HLFG,East and West Hanningfield      ,1876,1205,11,96,671
23HLFH,Galleywood                      ,4623,3044,16,195,1579
23HLFJ,Goat Hall                       ,4589,3287,13,144,1302
23HLFK,Great and Little Leighs and Litt,2279,1496,7,92,783
23HLFL,Little BaddowDanbury and Sandon ,6611,4129,18,186,2482
23HLFM,Margaretting and Stock          ,2469,1428,1,92,1041
23HLFN,Moulsham Lodge                  ,4330,3240,19,166,1090
23HLFP,Old Moulsham                    ,5973,4094,15,247,1879
23HLFQ,Patching Hall                   ,5852,3757,14,196,2095
23HLFR,Rettendon and Runwell           ,4636,2653,17,180,1983
23HLFS,Rothmans                        ,4623,3010,18,195,1613
23HLFT,St.Andrews                      ,7013,4124,25,300,2889
23HLFU,South Hanningfield              ,1852,1218,7,50,634
23HLFW,South Woodham-Collingwood East a,5498,4246,12,177,1252
23HLFX,South Woodham-Elmwood and Woodvi,6318,4620,29,201,1698
23HLFY,Springfield North               ,6554,5176,15,233,1378
23HLFZ,Springfield South               ,4553,3562,12,175,991
23HLGA,The Lawns                       ,5044,3491,14,137,1553
23HLGB,Waterhouse Farm                 ,4925,3118,16,236,1807
23HLGC,Woodham Ferrers and Bicknacre   ,2382,1704,5,71,678
23HLGD,Writtle                         ,4283,2636,9,156,1647
23HLSS,Shipping                        ,0,0,0,0,0
23HMFA,Berechurch                      ,6008,4068,33,340,1940
23HMFB,Birch/Messing and Copford       ,2445,1498,18,65,947
23HMFC,Boxted and Langham              ,1849,1158,7,47,691
23HMFD,Castle                          ,5542,3426,27,291,2116
23HMFE,Dedham                          ,1531,877,8,41,654
23HMFF,East Donyland                   ,1762,1152,8,83,610
23HMFG,Fordham                         ,1423,922,8,38,501
23HMFH,Great and Little Horkesley      ,1821,1204,17,62,617
23HMFJ,Great Tey                       ,1743,1098,6,55,645
23HMFK,Harbour                         ,5701,3607,35,311,2094
23HMFL,Lexden                          ,4377,2502,16,159,1875
23HMFM,Marks Tey                       ,2016,1443,6,72,573
23HMFN,Mile End                        ,7582,4976,55,278,2606
23HMFP,New Town                        ,5511,3856,39,342,1655
23HMFQ,Prettygate                      ,5817,3489,31,133,2328
23HMFR,Pyefleet                        ,1851,1106,10,55,745
23HMFS,St.Andrew's                     ,6070,3759,34,507,2311
23HMFT,St.Anne's                       ,5330,3502,48,353,1828
23HMFU,St.John's                       ,5724,3611,25,168,2113
23HMFW,St.Mary's                       ,5484,3390,31,247,2094
23HMFX,Shrub End                       ,5730,3814,48,330,1916
23HMFY,Stanway                         ,5810,3812,34,199,1998
23HMFZ,Tiptree                         ,6076,3909,27,264,2167
23HMGA,West Bergholt and Eight Ash Gree,3723,2364,24,144,1359
23HMGB,West Mersea                     ,5444,2875,27,187,2569
23HMGC,Winstree                        ,1786,1203,8,60,583
23HMGD,Wivenhoe                        ,5422,3311,26,215,2111
23HMSS,Shipping                        ,0,0,0,0,0
23HNFA,Broadway                        ,4225,2012,19,183,2213
23HNFB,Buckhurst Hill East             ,4137,2580,13,183,1557
23HNFC,Buckhurst Hill West             ,5174,3278,16,184,1896
23HNFD,Chigwell Row                    ,1826,1139,5,53,687
23HNFE,Chigwell Village                ,3385,2154,8,114,1231
23HNFF,Chipping Ongar                  ,1399,903,2,38,496
23HNFG,Debden Green                    ,4051,2265,10,218,1786
23HNFH,Epping Hemnall                  ,4846,3026,12,180,1820
23HNFJ,Epping Lindsey                  ,4893,3075,17,163,1818
23HNFK,Grange Hill                     ,4856,3149,23,244,1707
23HNFL,Greensted and Marden Ash        ,1963,1294,2,66,669
23HNFM,High Beach                      ,2318,1497,3,118,821
23HNFN,High Ongar                      ,911,551,4,43,360
23HNFP,Lambourne                       ,1552,887,3,58,665
23HNFQ,Loughton Forest                 ,3058,1942,11,113,1116
23HNFR,Loughton Roding                 ,4211,2592,12,230,1619
23HNFS,Loughton St.John's              ,4290,2730,22,186,1560
23HNFT,Loughton St.Mary's              ,3512,2113,14,140,1399
23HNFU,Moreton and Matching            ,1643,1025,1,61,618
23HNFW,Nazeing                         ,3799,2488,11,142,1311
23HNFX,North Weald Bassett             ,4465,2991,11,170,1474
23HNFY,Passingford                     ,1649,1094,15,85,555
23HNFZ,Paternoster                     ,3611,2111,21,223,1500
23HNGA,Roothing Country                ,1288,804,10,32,484
23HNGB,Roydon                          ,2328,1553,12,106,775
23HNGC,Sheering                        ,2050,1510,4,90,540
23HNGD,Shelley                         ,1470,909,8,76,561
23HNGE,Theydon Bois                    ,3249,1883,5,70,1366
23HNGF,Waltham Abbey East              ,4994,3421,23,287,1573
23HNGG,Waltham Abbey West              ,4048,2627,25,226,1421
23HNSS,Shipping                        ,0,0,0,0,0
23HPFA,Brays Grove                     ,3146,1969,19,192,1177
23HPFB,Great Parndon                   ,3321,2340,14,158,981
23HPFC,Hare Street and Town Centre     ,2848,1781,16,210,1067
23HPFD,Katherines with Sumners         ,4881,3701,31,292,1180
23HPFE,Kingsmoor                       ,5085,3919,36,392,1166
23HPFF,Latton Bush                     ,4089,2895,19,257,1194
23HPFG,Little Parndon                  ,4278,2909,23,254,1369
23HPFH,Mark Hall North                 ,2190,1269,11,105,921
23HPFJ,Mark Hall South                 ,3932,2290,23,252,1642
23HPFK,Netteswell East                 ,2861,1721,13,166,1140
23HPFL,Netteswell West                 ,2591,1654,19,190,937
23HPFM,Old Harlow                      ,4828,3026,16,201,1802
23HPFN,Passmores                       ,3885,2637,20,272,1248
23HPFP,Potter Street                   ,3128,1961,35,166,1167
23HPFQ,Stewards                        ,3822,2798,21,319,1024
23HPFR,Tye Green                       ,3670,2459,14,224,1211
23HPSS,Shipping                        ,0,0,0,0,0
23HQFA,Althorne                        ,1824,1111,3,90,713
23HQFB,Burnham-on-Crouch North         ,2041,1182,5,61,859
23HQFC,Burnham-on-Crouch South         ,3651,2120,14,187,1531
23HQFD,Cold Norton                     ,1534,1028,8,53,506
23HQFE,Goldhanger                      ,1270,791,4,68,479
23HQFF,Great Totham                    ,2461,1613,6,86,848
23HQFG,Heybridge East                  ,2916,2166,10,96,750
23HQFH,Heybridge West                  ,2060,1348,11,113,712
23HQFJ,Maldon East                     ,2092,1117,5,117,975
23HQFK,Maldon North West               ,3269,1899,9,156,1370
23HQFL,Maldon South                    ,3334,2285,17,105,1049
23HQFM,Purleigh                        ,1258,824,6,62,434
23HQFN,St.Lawrence                     ,1168,654,4,58,514
23HQFP,Southminster                    ,2642,1699,7,129,943
23HQFQ,The Maylands                    ,2457,1658,12,126,799
23HQFR,Tillingham                      ,1361,846,3,53,515
23HQFS,Tollesbury                      ,2020,1257,4,82,763
23HQFT,Tolleshunt D'arcy               ,1532,998,7,61,534
23HQFU,Wickham Bishops                 ,1706,1034,5,59,672
23HQFW,Woodham                         ,1318,839,6,68,479
23HQSS,Shipping                        ,0,0,0,0,0
23HRFA,Ashingdon                       ,2410,1530,6,113,880
23HRFB,Barling and Sutton              ,1412,901,6,70,511
23HRFC,Canewdon                        ,1792,1206,8,79,586
23HRFD,Downhall                        ,2812,1863,7,103,949
23HRFE,Foulness and Great Wakering East,1722,1218,16,98,504
23HRFF,Grange and Rawreth              ,4409,2711,33,218,1698
23HRFG,Great Wakering Central          ,1383,854,10,51,529
23HRFH,Great Wakering West             ,1036,638,4,37,398
23HRFJ,Hawkwell East                   ,5331,3477,27,176,1854
23HRFK,Hawkwell West                   ,3191,2025,11,112,1166
23HRFL,Hockley Central                 ,1882,1102,6,62,780
23HRFM,Hockley East                    ,3175,1871,11,94,1304
23HRFN,Hockley West                    ,2274,1636,10,66,638
23HRFP,Hullbridge Riverside            ,3169,1980,13,136,1189
23HRFQ,Hullbridge South                ,2399,1580,18,97,819
23HRFR,Lodge                           ,4834,3142,26,152,1692
23HRFS,Rayleigh Central                ,2985,1774,11,113,1211
23HRFT,Rochford Eastwood               ,1380,825,8,69,555
23HRFU,Rochford Roche                  ,1668,966,9,91,702
23HRFW,Rochford St.Andrews             ,2628,1371,16,123,1257
23HRFX,Trinity                         ,3103,1944,14,105,1159
23HRFY,Wheatley                        ,2506,1450,23,64,1056
23HRFZ,Whitehouse                      ,2755,1534,18,79,1221
23HRSS,Shipping                        ,0,0,0,0,0
23HSFA,Belfairs                        ,9321,4785,31,371,4536
23HSFB,Blenheim                        ,9579,5207,44,522,4372
23HSFC,Chalkwell                       ,9840,5266,37,448,4574
23HSFD,Eastwood                        ,10955,6875,38,419,4080
23HSFE,Leigh                           ,9434,5517,36,391,3917
23HSFF,Milton                          ,9113,5417,36,776,3696
23HSFG,Prittlewell                     ,9649,5207,39,428,4442
23HSFH,St.Lukes                        ,8667,5205,51,531,3462
23HSFJ,Shoebury                        ,14101,8835,95,796,5266
23HSFK,Southchurch                     ,9378,5054,36,460,4324
23HSFL,Thorpe                          ,10292,5710,43,496,4582
23HSFM,Victoria                        ,9952,5622,50,696,4330
23HSFN,Westborough                     ,9049,5926,46,566,3123
23HSSS,Shipping                        ,0,0,0,0,0
23HTFA,AlresfordThorrington and Fratin ,2897,1807,22,81,1090
23HTFB,Ardleigh                        ,1544,995,10,56,549
23HTFC,Beaumont and Thorpe             ,1795,989,10,61,806
23HTFD,Bockings Elm                    ,8675,4597,62,507,4078
23HTFE,BradfieldWrabness and Wix       ,1723,1014,10,59,709
23HTFF,Brightlingsea East              ,3013,1677,14,112,1336
23HTFG,Brightlingsea West              ,3098,1819,12,111,1279
23HTFH,Elmstead                        ,1942,1189,11,57,753
23HTFJ,Frinton                         ,5081,1687,13,129,3394
23HTFK,Golf Green                      ,3681,1369,15,259,2312
23HTFL,Great and Little Oakley         ,1640,977,7,76,663
23HTFM,Great Bentley                   ,1798,1081,6,63,717
23HTFN,Great BromleyLittle Bromley and ,1278,773,10,32,505
23HTFP,Harwich East                    ,2728,1618,16,216,1110
23HTFQ,Harwich East Central            ,2822,1737,21,147,1085
23HTFR,Harwich West                    ,4007,2310,27,208,1697
23HTFS,Harwich West Central            ,2895,1537,19,143,1358
23HTFT,Haven                           ,2680,816,10,64,1864
23HTFU,Holland and Kirby               ,4469,1977,14,150,2492
23HTFW,Lawford and Manningtree         ,4038,2628,19,160,1410
23HTFX,Little Clacton                  ,2316,1122,5,106,1194
23HTFY,Mistley                         ,1769,1092,9,90,677
23HTFZ,Ramsey                          ,1779,1055,8,97,724
23HTGA,Rush Green                      ,4298,2385,36,294,1913
23HTGB,St.Bartholomews                 ,2804,889,10,89,1915
23HTGC,St.James                        ,5066,2327,33,354,2739
23HTGD,St.Johns                        ,5616,2363,42,242,3253
23HTGE,St.Marys                        ,4062,2045,38,333,2017
23HTGF,St.Osyth                        ,3242,1624,18,175,1618
23HTGG,Southcliff                      ,4400,1825,13,171,2575
23HTGH,Tendring and Weeley             ,1857,1083,7,93,774
23HTGJ,Walton                          ,5538,1948,14,224,3590
23HTSS,Shipping                        ,0,0,0,0,0
23HUFA,Aveley                          ,5866,3437,27,366,2429
23HUFB,Belhus                          ,5841,3264,35,484,2577
23HUFC,Chadwell St.Mary                ,7557,4449,50,548,3108
23HUFD,Corringham and Fobbing          ,9752,6493,42,478,3259
23HUFE,East Tilbury                    ,4546,3302,15,226,1244
23HUFF,Grays Thurrock North            ,2998,1719,16,149,1279
23HUFG,Grays Thurrock Town             ,9113,6446,26,598,2667
23HUFH,Little Thurrock                 ,8863,5843,35,374,3020
23HUFJ,Ockendon                        ,6718,3563,23,391,3155
23HUFK,Orsett                          ,3972,2698,27,130,1274
23HUFL,Stanford-le-Hope                ,8114,5287,45,403,2827
23HUFM,Stifford                        ,6681,3732,24,252,2949
23HUFN,The Homesteads                  ,6189,4785,46,238,1404
23HUFP,Tilbury                         ,8473,5208,48,806,3265
23HUFQ,West Thurrock                   ,5720,4103,17,390,1617
23HUSS,Shipping                        ,0,0,0,0,0
23HWFA,Ashdon                          ,859,564,2,26,295
23HWFB,Birchanger                      ,835,578,3,28,257
23HWFC,Clavering                       ,1340,831,0,35,509
23HWFD,Elsenham                        ,1657,1206,9,54,451
23HWFE,Felsted                         ,2288,1414,8,90,874
23HWFF,Great Dunmow(North)             ,2320,1480,11,93,840
23HWFG,Great Dunmow(South)             ,2976,1900,8,83,1076
23HWFH,Great Hallingbury               ,796,529,1,30,267
23HWFJ,Hatfield Broad Oak              ,931,635,0,29,296
23HWFK,Hatfield Heath                  ,1222,760,5,35,462
23HWFL,Henham                          ,1272,814,4,46,458
23HWFM,Littlebury                      ,957,633,1,27,324
23HWFN,Little Hallingbury              ,1137,729,6,38,408
23HWFP,Newport                         ,1680,1106,10,37,574
23HWFQ,Rickling                        ,0,0,0,0,0
23HWFR,Saffron Walden(Audley)          ,2397,1283,1,56,1114
23HWFS,Saffron Walden(Castle)          ,2979,1970,9,105,1009
23HWFT,Saffron Walden(Plantation)      ,3212,2430,6,113,782
23HWFU,Saffron Walden(Shire)           ,2548,1528,1,64,1020
23HWFW,Stansted Mountfitchet           ,4274,2965,19,198,1309
23HWFX,Stebbing                        ,1167,774,0,37,393
23HWFY,Stort Valley                    ,1938,1216,0,72,722
23HWFZ,Takeley                         ,2241,1539,4,94,702
23HWGA,Thaxted                         ,2174,1319,7,76,855
23HWGB,The Canfields                   ,1475,980,0,51,495
23HWGC,The Chesterfords                ,1239,813,5,28,426
23HWGD,The Eastons                     ,1071,660,3,31,411
23HWGE,The Rodings                     ,1048,661,2,32,387
23HWGF,The Sampfords                   ,1331,808,6,53,523
23HWGG,Wenden Lofts                    ,1145,713,2,38,432
23HWGH,Wimbish and Debden              ,1670,1204,14,47,466
23HWSS,Shipping                        ,0,0,0,0,0
24HXFA,All Saints                      ,6844,4585,27,315,2259
24HXFB,Charlton Kings                  ,6517,3896,19,188,2621
24HXFC,College                         ,6866,3937,23,172,2929
24HXFD,Hatherley and The Reddings      ,7656,4884,36,204,2772
24HXFE,Hesters Way                     ,7510,5073,47,453,2437
24HXFF,Lansdown                        ,6162,3672,23,346,2490
24HXFG,Leckhampton With Up Hatherley   ,5590,3644,20,146,1946
24HXFH,Park                            ,5655,3185,18,166,2470
24HXFJ,Pittville                       ,6212,3570,23,384,2642
24HXFK,Prestbury                       ,5951,3689,16,150,2262
24HXFL,St.Mark's                       ,5651,3294,34,356,2357
24HXFM,St.Paul's                       ,6091,3832,28,485,2259
24HXFN,St.Peter's                      ,6006,4096,36,309,1910
24HXFP,Swindon                         ,1493,1134,2,37,359
24HXSS,Shipping                        ,0,0,0,0,0
24HYFA,Ampneys                         ,975,575,2,29,400
24HYFB,Avening                         ,1438,906,3,47,532
24HYFC,Beacon                          ,1512,952,42,38,560
24HYFD,Blockley                        ,1410,820,3,55,590
24HYFE,Bourton-on-the-Water            ,2543,1313,14,59,1230
24HYFF,Campden                         ,2094,1088,7,34,1006
24HYFG,Churn Valley                    ,1108,671,2,19,437
24HYFH,Cirencester Abbey               ,2231,1041,8,57,1190
24HYFJ,Cirencester Beeches             ,2971,1983,20,102,988
24HYFK,Cirencester Chesterton          ,3527,2269,13,155,1258
24HYFL,Cirencester Stratton            ,1869,1204,6,56,665
24HYFM,Cirencester Watermoor           ,3275,1935,15,162,1340
24HYFN,Coln                            ,1406,810,1,46,596
24HYFP,Ermin                           ,1586,960,3,44,626
24HYFQ,Evenlode Vale                   ,1059,588,2,26,471
24HYFR,Fairford                        ,2364,1441,9,99,923
24HYFS,Fossehill                       ,1328,813,4,27,515
24HYFT,Fosseridge                      ,1172,697,1,38,475
24HYFU,Grumbold's Ash                  ,1023,664,5,24,359
24HYFW,Hampton                         ,1117,666,5,34,451
24HYFX,Kempsford                       ,944,664,12,31,280
24HYFY,Lechlade                        ,1903,1106,0,87,797
24HYFZ,Mickleton                       ,1321,721,2,28,600
24HYGA,Moreton-in-Marsh                ,2337,1358,11,95,979
24HYGB,Northleach                      ,1377,805,2,45,572
24HYGC,Sandywell                       ,1635,1002,9,49,633
24HYGD,Sherborne Brook                 ,1159,693,1,34,466
24HYGE,Stow-on-the-Wold                ,1704,968,4,55,736
24HYGF,Tetbury                         ,4070,2535,15,119,1535
24HYGG,Thames Head                     ,1495,914,3,45,581
24HYGH,Three Rivers                    ,1510,903,6,40,607
24HYGJ,Vale                            ,1139,625,1,29,514
24HYGK,Water Park                      ,3791,2507,19,129,1284
24HYSS,Shipping                        ,0,0,0,0,0
24HZFA,Alvington and Aylburton         ,990,584,6,59,406
24HZFB,Awre                            ,1322,797,11,50,525
24HZFC,Blaisdon and Longhope           ,1405,863,4,41,542
24HZFD,Bream                           ,2882,1738,22,127,1144
24HZFE,Broadwell                       ,4114,2553,37,187,1561
24HZFF,Churcham and Huntley            ,1451,871,11,28,580
24HZFG,Cinderford                      ,6117,3726,54,317,2391
24HZFH,Coleford                        ,4062,2437,25,214,1625
24HZFJ,Drybrook                        ,2218,1306,12,104,912
24HZFK,Dymock and Kempley              ,1284,752,3,37,532
24HZFL,Hartpury                        ,1149,746,8,30,403
24HZFM,Hewelsfield and St.Briavels     ,1420,812,9,42,608
24HZFN,Littledean                      ,1010,592,9,46,418
24HZFP,Lydbrook                        ,1877,1166,11,110,711
24HZFQ,Lydney                          ,5964,3500,50,292,2464
24HZFR,Mitcheldean                     ,2066,1298,9,71,768
24HZFS,Newent and Oxenhall             ,1211,736,6,16,475
24HZFT,Newent Central                  ,3308,1966,15,113,1342
24HZFU,Newland                         ,1364,780,7,56,584
24HZFW,Newnham                         ,987,570,8,42,417
24HZFX,Pillowell                       ,2733,1643,25,117,1090
24HZFY,Redmarley                       ,1360,839,5,42,521
24HZFZ,Ruardean                        ,1194,715,11,50,479
24HZGA,Ruspidge                        ,1925,1163,15,89,762
24HZGB,Tibberton                       ,987,625,3,25,362
24HZGC,Tidenham                        ,4029,2481,29,139,1548
24HZGD,Westbury-on-Severn              ,1419,847,10,41,572
24HZGE,Woolaston                       ,999,591,9,30,408
24HZSS,Shipping                        ,0,0,0,0,0
24JAFA,Barnwood                        ,10856,7665,67,446,3191
24JAFB,Barton                          ,5652,3600,58,527,2052
24JAFC,Eastgate                        ,6413,3992,52,410,2421
24JAFD,Hucclecote                      ,7812,4963,29,244,2849
24JAFE,Kingsholm                       ,6863,4203,35,245,2660
24JAFF,Linden                          ,5694,3678,44,306,2016
24JAFG,Longlevens                      ,6951,4540,43,169,2411
24JAFH,Matson                          ,6177,3647,52,449,2530
24JAFJ,Podsmead                        ,6047,3937,29,323,2110
24JAFK,Quedgeley                       ,5625,4307,27,144,1318
24JAFL,Tuffley                         ,6373,3827,32,296,2546
24JAFM,Westgate                        ,5742,3489,78,511,2253
24JASS,Shipping                        ,0,0,0,0,0
24JBFA,Berkeley                        ,1885,1198,5,76,687
24JBFB,Bisley                          ,1705,988,9,39,717
24JBFC,Cainscross                      ,4567,2932,35,173,1635
24JBFD,Cam                             ,3672,2361,18,125,1311
24JBFE,Cambridge                       ,1414,893,5,52,521
24JBFF,Central                         ,1129,687,3,56,442
24JBFG,Chalford                        ,3735,2357,12,108,1378
24JBFH,Dursley                         ,4561,2671,17,212,1890
24JBFJ,Eastington                      ,1321,827,3,36,494
24JBFK,Hardwicke                       ,2794,2104,10,76,690
24JBFL,Hinton                          ,914,578,3,43,336
24JBFM,King's Stanley                  ,2960,1791,11,74,1169
24JBFN,Leonard Stanley                 ,1215,723,8,47,492
24JBFP,Minchinhampton                  ,4272,2273,19,123,1999
24JBFQ,Nailsworth                      ,4746,3044,28,188,1702
24JBFR,Nibley                          ,1024,589,5,36,435
24JBFS,Painswick                       ,3559,1817,14,93,1742
24JBFT,Parklands                       ,1506,944,6,52,562
24JBFU,Randwick                        ,1234,811,7,41,423
24JBFW,Rodborough                      ,4397,2897,25,164,1500
24JBFX,Severn                          ,1931,1196,15,77,735
24JBFY,Stonehouse                      ,5337,3270,32,237,2067
24JBFZ,Thrupp                          ,1420,890,3,69,530
24JBGA,Trinity                         ,3925,2514,36,209,1411
24JBGB,Uley                            ,1214,700,2,42,514
24JBGC,Uplands                         ,4312,2695,24,178,1617
24JBGD,Upton St.Leonards               ,1369,780,4,26,589
24JBGE,Vale                            ,1434,847,6,40,587
24JBGF,Whiteshill                      ,982,618,3,30,364
24JBGG,Woodfield                       ,2836,1689,13,126,1147
24JBGH,Wotton and Kingswood            ,5884,3496,27,193,2388
24JBSS,Shipping                        ,0,0,0,0,0
24JCFA,Ashchurch                       ,4606,3498,18,171,1108
24JCFB,Bishop's Cleeve East            ,1412,881,7,58,531
24JCFC,Bishop's Cleeve North           ,2159,1234,8,67,925
24JCFD,Bishop's Cleeve South           ,2439,1675,7,53,764
24JCFE,Brockworth Glebe                ,1001,621,9,46,380
24JCFF,Brockworth Moorfield            ,1200,671,4,63,529
24JCFG,Brockworth Westfield            ,1256,816,0,41,440
24JCFH,Churchdown Brookfield           ,2712,1555,7,65,1157
24JCFJ,Churchdown Parton               ,3112,2127,11,139,985
24JCFK,Churchdown Pirton               ,2461,1693,8,88,768
24JCFL,Cleeve Hill                     ,2975,1845,9,66,1130
24JCFM,Coombe Hill                     ,2536,1578,9,97,958
24JCFN,Crickley                        ,1049,632,6,42,417
24JCFP,De Winton                       ,2425,1616,8,93,809
24JCFQ,Dumbleton                       ,1564,926,1,41,638
24JCFR,Gotherington                    ,1876,1138,6,30,738
24JCFS,Haw Bridge                      ,1470,882,9,36,588
24JCFT,Highnam                         ,1885,1234,7,32,651
24JCFU,Horsbere                        ,2362,1547,10,69,815
24JCFW,Innsworth                       ,1384,916,18,52,468
24JCFX,Shurdington                     ,1859,1018,5,67,841
24JCFY,Tewkesbury Mitton               ,1411,970,7,40,441
24JCFZ,Tewkesbury Newtown              ,1545,1089,10,58,456
24JCGA,Tewkesbury Prior's Park         ,2804,1740,16,145,1064
24JCGB,Tewkesbury Town                 ,1957,1196,10,87,761
24JCGC,Twyning                         ,1212,712,2,34,500
24JCGD,Winchcombe                      ,4242,2381,15,113,1861
24JCSS,Shipping                        ,0,0,0,0,0
25JDFA,Basing                          ,9791,7389,16,268,2402
25JDFB,Baughurst                       ,1956,1304,20,40,652
25JDFC,Black Dam                       ,2049,1570,12,104,479
25JDFD,Bramley                         ,1983,1403,0,59,580
25JDFE,Brighton Hill                   ,5257,4021,23,232,1236
25JDFF,Buckskin                        ,3582,2566,18,224,1016
25JDFG,Burghclere                      ,2055,1344,21,68,711
25JDFH,Chapel                          ,1540,1046,6,89,494
25JDFJ,Daneshill                       ,4080,3089,41,304,991
25JDFK,Eastrop                         ,2876,1992,12,105,884
25JDFL,East Woodhay                    ,3278,2178,5,79,1100
25JDFM,Farleigh Wallop                 ,4969,4013,16,174,956
25JDFN,Kempshott                       ,4954,3824,17,130,1130
25JDFP,Kingsclere                      ,3808,2573,14,118,1235
25JDFQ,King's Furlong                  ,4154,3016,27,168,1138
25JDFR,Norden                          ,4742,3191,25,317,1551
25JDFS,North Waltham                   ,1770,1176,4,46,594
25JDFT,Oakley                          ,4644,3157,20,126,1487
25JDFU,Overton                         ,3304,2160,11,72,1144
25JDFW,Pamber                          ,2196,1499,10,81,697
25JDFX,Popley                          ,3160,2365,20,189,795
25JDFY,St. Mary Bourne                 ,1295,827,8,25,468
25JDFZ,Sherborne St. John              ,1830,1113,4,49,717
25JDGA,Sherfield on Loddon             ,1417,962,2,42,455
25JDGB,Silchester                      ,1120,743,7,27,377
25JDGC,South Ham                       ,4213,2653,24,244,1560
25JDGD,Tadley Central                  ,2323,1702,18,61,621
25JDGE,Tadley North                    ,2475,1717,26,55,758
25JDGF,Tadley South                    ,4134,3237,25,127,897
25JDGG,Upton Grey                      ,2192,1349,3,58,843
25JDGH,Viables                         ,3352,2427,20,103,925
25JDGJ,Westside                        ,4217,2552,15,236,1665
25JDGK,Whitchurch                      ,3465,2246,17,95,1219
25JDGL,Winklebury                      ,6208,4353,43,290,1855
25JDSS,Shipping                        ,0,0,0,0,0
25JEFA,Alton Holybourne                ,1788,1178,5,47,610
25JEFB,Alton North East                ,3388,2294,9,124,1094
25JEFC,Alton North West                ,2521,1798,11,78,723
25JEFD,Alton South East                ,1325,776,8,49,549
25JEFE,Alton South West and Beech      ,3996,2763,18,102,1233
25JEFF,Binsted                         ,1386,906,1,37,480
25JEFG,Bramshott and Liphook           ,5871,3572,27,165,2299
25JEFH,Clanfield and Buriton           ,3664,2430,20,98,1234
25JEFJ,East Meon and Langrish          ,1205,790,3,28,415
25JEFK,Farringdon                      ,1066,669,4,26,397
25JEFL,Four Marks                      ,2271,1439,9,65,832
25JEFM,Froxfield and Steep             ,1426,854,5,53,572
25JEFN,Froyle and Bentley              ,1252,796,4,36,456
25JEFP,Grayshott                       ,1760,973,4,26,787
25JEFQ,Headley                         ,4322,2657,9,189,1665
25JEFR,Horndean-Catherington           ,2929,2004,22,94,925
25JEFS,Horndean-Hazleton               ,1782,1075,6,44,707
25JEFT,Horndean-Kings                  ,2644,1757,15,73,887
25JEFU,Horndean-Murray                 ,2166,1423,14,88,743
25JEFW,Liss                            ,4564,2743,24,120,1821
25JEFX,Medstead                        ,1578,951,5,57,627
25JEFY,North Downland                  ,1125,715,1,35,410
25JEFZ,Petersfield-Heath               ,2288,1427,5,72,861
25JEGA,Petersfield-St.Mary's           ,4203,2488,4,109,1715
25JEGB,Petersfield-St.Peters           ,3734,2318,8,102,1416
25JEGC,Ropley and West Tisted          ,1340,836,2,30,504
25JEGD,Rowlands Castle                 ,2195,1396,11,71,799
25JEGE,Selborne                        ,1726,1141,4,52,585
25JEGF,The Hangers                     ,1089,656,4,36,433
25JEGG,Whitehill-Bordon and Whitehill  ,9624,7210,53,379,2414
25JEGH,Whitehill-Lindford              ,1763,1267,5,45,496
25JESS,Shipping                        ,0,0,0,0,0
25JFFA,Bishopstoke                     ,7572,5032,32,275,2540
25JFFB,Botley                          ,3833,2643,11,128,1190
25JFFC,Bursledon                       ,4389,2921,18,204,1468
25JFFD,Chandler's Ford                 ,5004,3411,21,167,1593
25JFFE,Eastleigh Central               ,4496,3160,21,234,1336
25JFFF,Eastleigh North                 ,6809,4903,29,266,1906
25JFFG,Eastleigh South                 ,3913,2342,19,194,1571
25JFFH,Eastleigh West                  ,5864,3556,33,262,2308
25JFFJ,Fair Oak                        ,6263,4522,20,190,1741
25JFFK,Hamble                          ,2712,1578,17,78,1134
25JFFL,Hedge End St.John's             ,4832,3322,10,150,1510
25JFFM,Hedge End Wildern               ,5884,4260,27,209,1624
25JFFN,Hiltingbury East                ,4426,2636,13,69,1790
25JFFP,Hiltingbury West                ,4522,2875,12,108,1647
25JFFQ,Hound                           ,5356,3387,27,214,1969
25JFFR,West End North                  ,2706,1607,11,94,1099
25JFFS,West End South                  ,5104,3706,20,150,1398
25JFSS,Shipping                        ,0,0,0,0,0
25JGFA,Fareham East                    ,4983,3056,29,168,1927
25JGFB,Fareham North                   ,4928,3206,25,151,1722
25JGFC,Fareham North-West              ,5850,3959,24,301,1891
25JGFD,Fareham South                   ,5205,3424,33,309,1781
25JGFE,Fareham West                    ,5533,3371,29,159,2162
25JGFF,Hill Head                       ,6312,3884,36,156,2428
25JGFG,Locks Heath                     ,10664,7481,54,326,3183
25JGFH,Portchester Central             ,4620,2622,23,178,1998
25JGFJ,Portchester East                ,4180,2404,29,158,1776
25JGFK,Portchester West                ,5747,3887,49,166,1860
25JGFL,Sarisbury                       ,4791,2983,19,151,1808
25JGFM,Stubbington                     ,5571,3384,35,156,2187
25JGFN,Titchfield                      ,5666,3792,38,188,1874
25JGFP,Warsash                         ,5986,4038,35,209,1948
25JGSS,Shipping                        ,0,0,0,0,0
25JHFA,Alverstoke                      ,7152,5191,85,415,1961
25JHFB,Anglesey                        ,5596,3257,33,134,2339
25JHFC,Bridgemary                      ,5231,3335,41,297,1896
25JHFD,Brockhurst                      ,5985,3979,76,388,2006
25JHFE,Elson                           ,5435,3759,59,210,1676
25JHFF,Hardway and Forton              ,5847,3851,76,384,1996
25JHFG,Lee                             ,6102,3521,61,184,2581
25JHFH,Leesland                        ,5615,3586,51,226,2029
25JHFJ,Rowner                          ,6127,4077,71,327,2050
25JHFK,Town                            ,5931,3524,56,359,2407
25JHSS,Shipping                        ,0,0,0,0,0
25JJFA,Church Crookham                 ,4961,3410,19,137,1551
25JJFB,Crondall                        ,4804,3430,17,118,1374
25JJFC,Eversley                        ,1201,795,4,45,406
25JJFD,Fleet Courtmoor                 ,5488,3502,18,146,1986
25JJFE,Fleet Pondtail                  ,5341,3606,20,141,1735
25JJFF,Fleet West                      ,6174,3965,15,210,2209
25JJFG,Frogmore and Darby Green        ,4451,3466,15,211,985
25JJFH,Hartley Wintney                 ,4466,2807,21,134,1659
25JJFJ,Hawley                          ,4392,3444,45,151,948
25JJFK,Hook                            ,4578,3228,14,148,1350
25JJFL,Long Sutton                     ,1014,705,2,19,309
25JJFM,Odiham                          ,3797,2555,13,76,1242
25JJFN,Whitewater                      ,1189,754,3,28,435
25JJFP,Yateley East                    ,3716,2590,13,129,1126
25JJFQ,Yateley North                   ,3358,2487,12,117,871
25JJFR,Yateley West                    ,4796,3779,18,132,1017
25JJSS,Shipping                        ,0,0,0,0,0
25JKFA,Barncroft                       ,4438,2935,54,364,1503
25JKFB,Battins                         ,5998,3697,51,476,2301
25JKFC,Bedhampton                      ,6230,3533,24,234,2697
25JKFD,Bondfields                      ,5383,3415,49,504,1968
25JKFE,Cowplain                        ,7414,4863,48,243,2551
25JKFF,Emsworth                        ,7950,4410,33,234,3540
25JKFG,Hart Plain                      ,7032,4509,71,490,2523
25JKFH,Hayling East                    ,6631,3721,33,318,2910
25JKFJ,Hayling West                    ,6830,3815,28,271,3015
25JKFK,Purbrook                        ,7336,4605,48,305,2731
25JKFL,St.Faith's                      ,7309,4438,22,235,2871
25JKFM,Stakes                          ,8518,5601,61,550,2917
25JKFN,Warren Park                     ,5122,3111,42,551,2011
25JKFP,Waterloo                        ,8313,5516,38,333,2797
25JKSS,Shipping                        ,0,0,0,0,0
25JLFA,Barton                          ,3487,1304,4,101,2183
25JLFB,Bashley                         ,5959,3236,31,222,2723
25JLFC,Becton                          ,5055,2282,16,147,2773
25JLFD,Blackfield and Langley          ,3684,2184,8,187,1500
25JLFE,Boldre                          ,1657,900,4,67,757
25JLFF,Bransgore and Sopley            ,4149,2443,14,179,1706
25JLFG,Brockenhurst                    ,2808,1418,8,57,1390
25JLFH,Colbury                         ,1760,1013,7,44,747
25JLFJ,Copythorne South                ,1559,958,4,38,601
25JLFK,Dibden and Hythe North          ,6545,4134,17,248,2411
25JLFL,Dibden Purlieu                  ,2622,1659,5,71,963
25JLFM,Downlands                       ,1469,853,6,36,616
25JLFN,Fawley Holbury                  ,6962,4584,34,314,2378
25JLFP,Fordingbridge                   ,4789,2711,17,162,2078
25JLFQ,Forest North                    ,1804,1055,10,52,749
25JLFR,Forest North West               ,2019,1118,8,67,901
25JLFS,Forest South                    ,1723,969,3,45,754
25JLFT,Forest West                     ,4299,2528,16,153,1771
25JLFU,Hordle                          ,4128,2024,20,114,2104
25JLFW,Hythe South                     ,6172,3878,31,408,2294
25JLFX,Lymington Town                  ,6741,3279,21,200,3462
25JLFY,Lyndhurst                       ,2632,1376,8,62,1256
25JLFZ,Marchwood                       ,3651,2778,23,149,873
25JLGA,Milford                         ,3983,1457,12,92,2526
25JLGB,Milton                          ,3844,1448,3,100,2396
25JLGC,Netley Marsh                    ,1809,966,10,45,843
25JLGD,Pennington                      ,4453,2343,10,161,2110
25JLGE,Ringwood North                  ,3725,2020,7,142,1705
25JLGF,Ringwood South                  ,4395,2500,11,205,1895
25JLGG,Sway                            ,2741,1513,7,68,1228
25JLGH,Totton Central                  ,9424,6566,45,376,2858
25JLGJ,Totton North                    ,7073,4727,35,253,2346
25JLGK,Totton South                    ,4374,2792,14,174,1582
25JLSS,Shipping                        ,0,0,0,0,0
25JMFA,Charles Dickens                 ,10748,5807,130,1043,4941
25JMFB,Copnor                          ,11760,7835,84,482,3925
25JMFC,Cosham                          ,9364,5563,59,531,3801
25JMFD,Drayton and Farlington          ,10567,6228,52,270,4339
25JMFE,Fratton                         ,10663,7116,61,714,3547
25JMFF,Havelock                        ,10595,6642,68,671,3953
25JMFG,Highland                        ,10588,6646,50,518,3942
25JMFH,Hilsea                          ,12138,7770,115,534,4368
25JMFJ,Milton                          ,10547,6344,69,480,4203
25JMFK,Nelson                          ,11460,7264,102,845,4196
25JMFL,Paulsgrove                      ,10436,6249,75,974,4187
25JMFM,St.Jude                         ,10370,6053,56,806,4317
25JMFN,St.Thomas                       ,12107,6651,86,901,5456
25JMSS,Shipping                        ,0,0,0,0,0
25JNFA,Alexandra                       ,4346,3028,11,232,1318
25JNFB,Belle Vue                       ,3604,2325,12,166,1279
25JNFC,Cove                            ,4398,3307,12,145,1091
25JNFD,Empress                         ,3870,2551,19,110,1319
25JNFE,Fernhill                        ,4761,3615,15,146,1146
25JNFF,Grange                          ,3708,2455,12,191,1253
25JNFG,Heron Wood                      ,3302,1925,13,154,1377
25JNFH,Knellwood                       ,3670,2363,15,93,1307
25JNFJ,Manor                           ,4503,3052,11,157,1451
25JNFK,Mayfield                        ,4085,2894,18,258,1191
25JNFL,Newport                         ,3660,2696,27,157,964
25JNFM,Queens                          ,7480,6521,77,217,959
25JNFN,St.Johns                        ,5496,3964,29,166,1532
25JNFP,St.Marks                        ,4187,2926,15,161,1261
25JNFQ,Westheath                       ,4086,2932,17,166,1154
25JNSS,Shipping                        ,0,0,0,0,0
25JPFA,Bargate                         ,9315,5370,74,1072,3945
25JPFB,Bassett                         ,10705,6140,56,527,4565
25JPFC,Bitterne                        ,9798,5769,67,794,4029
25JPFD,Bitterne Park                   ,10635,6580,69,548,4055
25JPFE,Coxford                         ,12361,8361,110,803,4000
25JPFF,Freemantle                      ,10494,6877,81,803,3617
25JPFG,Harefield                       ,10624,6211,56,525,4413
25JPFH,Millbrook                       ,10364,6263,69,752,4101
25JPFJ,Peartree                        ,10854,6841,79,720,4013
25JPFK,Portswood                       ,9516,5563,36,583,3953
25JPFL,Redbridge                       ,10796,6252,75,831,4544
25JPFM,St.Lukes                        ,9119,5403,66,856,3716
25JPFN,Shirley                         ,10135,5867,50,415,4268
25JPFP,Sholing                         ,11725,7515,61,611,4210
25JPFQ,Woolston                        ,11046,6840,82,818,4206
25JPSS,Shipping                        ,0,0,0,0,0
25JQFA,Abbey                           ,3128,1575,6,122,1553
25JQFB,Alamein                         ,5965,4266,71,349,1699
25JQFC,Anna                            ,3157,2062,22,84,1095
25JQFD,Blackwater                      ,3995,2479,15,98,1516
25JQFE,Bourne Valley                   ,1574,1016,6,36,558
25JQFF,Chilworth and Nursling          ,4787,3226,30,153,1561
25JQFG,Cupernham                       ,4615,3116,13,162,1499
25JQFH,Dun Valley                      ,1665,1031,6,55,634
25JQFJ,Field                           ,1774,1069,5,44,705
25JQFK,Harewood                        ,2427,1566,7,67,861
25JQFL,Harroway                        ,5501,3887,33,202,1614
25JQFM,Kings Somborne and Michelmersh  ,1735,1172,8,65,563
25JQFN,Millway                         ,5777,3862,28,147,1915
25JQFP,Nether Wallop and Broughton     ,1478,862,7,28,616
25JQFQ,North Baddesley                 ,7302,5082,21,236,2220
25JQFR,Over Wallop                     ,1774,1371,27,51,403
25JQFS,Romsey Extra                    ,2429,1684,12,81,745
25JQFT,St.Mary's                       ,5238,3452,29,245,1786
25JQFU,Stockbridge                     ,1340,806,1,30,534
25JQFW,Tadburn                         ,3661,2516,14,117,1145
25JQFX,Tedworth                        ,3661,2676,29,114,985
25JQFY,Weyhill                         ,2610,1676,20,70,934
25JQFZ,Winton                          ,5167,3597,28,167,1570
25JQSS,Shipping                        ,0,0,0,0,0
25JRFA,Badger Farm                     ,1887,1530,6,53,357
25JRFB,Bishops Sutton                  ,1046,677,3,31,369
25JRFC,Bishops Waltham                 ,4709,3063,21,155,1646
25JRFD,Boarhunt and Southwick          ,1192,878,37,20,314
25JRFE,Cheriton                        ,1300,844,7,35,456
25JRFF,Compton                         ,1256,710,4,22,546
25JRFG,Curdridge                       ,1019,597,2,25,422
25JRFH,Denmead                         ,4457,2850,29,158,1607
25JRFJ,DroxfordSoberton and Hambledon  ,2442,1473,11,54,969
25JRFK,Durley and Upham                ,1183,736,2,31,447
25JRFL,Itchen Valley                   ,1268,784,6,33,484
25JRFM,Littleton                       ,3099,2088,13,89,1011
25JRFN,Micheldever                     ,1016,634,4,25,382
25JRFP,New Alresford                   ,4119,2554,15,88,1565
25JRFQ,Olivers Battery                 ,1299,744,9,21,555
25JRFR,Otterbourne and Hursley         ,1808,1112,10,35,696
25JRFS,Owlesbury and Colden Common     ,3152,2073,11,104,1079
25JRFT,St.Barnabas                     ,4080,2363,13,104,1717
25JRFU,St.Bartholomew                  ,4124,2258,10,159,1866
25JRFW,St.John and All Saints          ,4406,2746,14,224,1660
25JRFX,St.Luke                         ,4256,2667,20,206,1589
25JRFY,St.Michael                      ,3868,2041,16,129,1827
25JRFZ,St.Paul                         ,3927,2458,16,113,1469
25JRGA,Shedfield                       ,1191,711,6,26,480
25JRGB,Sparsholt                       ,868,559,2,24,309
25JRGC,Swanmore                        ,2103,1362,12,59,741
25JRGD,The Worthys                     ,3609,2291,16,82,1318
25JRGE,Twyford                         ,1075,634,1,22,441
25JRGF,Upper Meon Valley               ,1339,771,4,32,568
25JRGG,Waltham Chase                   ,1647,1136,13,47,511
25JRGH,Wickham                         ,2450,1352,14,99,1098
25JRGJ,Wonston                         ,3044,2031,13,60,1013
25JRSS,Shipping                        ,0,0,0,0,0
26JSFA,Alvechurch                      ,4836,3034,25,144,1802
26JSFB,Barnt Green                     ,4290,2651,9,100,1639
26JSFC,Beacon                          ,3323,2329,22,126,994
26JSFD,Catshill                        ,5048,3420,20,175,1628
26JSFE,Charford                        ,4391,2780,37,228,1611
26JSFF,Cofton Hackett                  ,1470,948,5,35,522
26JSFG,Drakes Cross                    ,5575,3710,14,202,1865
26JSFH,Furlongs                        ,3356,1948,9,86,1408
26JSFJ,Hagley                          ,3517,2038,10,94,1479
26JSFK,Majors Green                    ,1710,1197,5,56,513
26JSFL,Norton                          ,4841,3016,11,131,1825
26JSFM,Sidemoor                        ,4748,2901,30,226,1847
26JSFN,South Wythall                   ,1896,1219,13,42,677
26JSFP,Stoke Prior                     ,2120,1432,7,81,688
26JSFQ,Stoney Hill                     ,4381,2922,9,121,1459
26JSFR,Tardebigge                      ,1504,971,6,40,533
26JSFS,Uffdown                         ,7453,4551,81,609,2902
26JSFT,Waseley                         ,2950,1991,32,138,959
26JSFU,Whitford                        ,4209,2908,18,141,1301
26JSFW,Woodvale                        ,1808,1156,4,51,652
26JSSS,Shipping                        ,0,0,0,0,0
26JTFA,Aylestone                       ,4511,2737,30,177,1774
26JTFB,Belmont                         ,4294,2808,50,313,1486
26JTFC,Central                         ,4130,2481,46,260,1649
26JTFD,Hinton                          ,4202,2546,26,228,1656
26JTFE,Holmer                          ,5648,3742,52,283,1906
26JTFF,St.Martins                      ,3686,2202,41,225,1484
26JTFG,St.Nicholas                     ,3741,2353,33,229,1388
26JTFH,Three Elms                      ,4671,3072,34,140,1599
26JTFJ,Tupsley                         ,5267,3105,35,129,2162
26JTSS,Shipping                        ,0,0,0,0,0
26JUFA,Bateman                         ,2412,1348,13,75,1064
26JUFB,Bayton and Mamble               ,0,0,0,0,0
26JUFC,Berrington                      ,1042,581,6,20,461
26JUFD,Bircher                         ,1387,687,6,43,700
26JUFE,Border                          ,0,0,0,0,0
26JUFF,Castle                          ,920,519,2,34,401
26JUFG,Eardisley                       ,0,0,0,0,0
26JUFH,Golden Cross                    ,1102,656,9,43,446
26JUFJ,Hampton Court                   ,1239,722,1,36,517
26JUFK,Hatfield                        ,950,571,3,33,379
26JUFL,Hergest                         ,1568,885,9,47,683
26JUFM,Kingsland                       ,0,0,0,0,0
26JUFN,Kington Town                    ,1835,1045,12,49,790
26JUFP,Kyre Vale                       ,0,0,0,0,0
26JUFQ,Leintwardine                    ,1925,1101,15,76,824
26JUFR,Leominster East                 ,1696,872,9,51,824
26JUFS,Leominster North                ,3862,2340,31,178,1522
26JUFT,Leominster South                ,2474,1425,20,127,1049
26JUFU,Lindridge                       ,1383,849,5,53,534
26JUFW,Lyonshall with Titley           ,918,503,3,22,415
26JUFX,Mansel                          ,0,0,0,0,0
26JUFY,Mortimer                        ,0,0,0,0,0
26JUFZ,Pembridge                       ,0,0,0,0,0
26JUGA,Pyons with Birley               ,889,526,7,36,363
26JUGB,Tenbury Town                    ,2247,1238,9,52,1009
26JUGC,Upton                           ,1081,634,13,27,447
26JUGD,Valley of the Teme              ,1436,853,5,35,583
26JUGE,Weobley                         ,887,446,3,37,441
26JUGF,Wye                             ,1294,754,5,47,540
26JUSS,Shipping                        ,0,0,0,0,0
26JWFA,Baldwin                         ,1574,928,9,57,646
26JWFB,Bringsty                        ,1150,741,4,51,409
26JWFC,Broadheath                      ,1427,968,9,33,459
26JWFD,Bromyard                        ,2770,1589,27,109,1181
26JWFE,Butterley                       ,1165,754,6,25,411
26JWFF,Chase                           ,4812,2469,21,155,2343
26JWFG,Cradley                         ,1325,805,7,38,520
26JWFH,Frome                           ,1102,680,3,60,422
26JWFJ,Frome Vale                      ,1353,826,3,51,527
26JWFK,Hallow                          ,1463,929,9,43,534
26JWFL,Hegdon                          ,1074,681,10,37,393
26JWFM,Hope End                        ,2495,1344,8,77,1151
26JWFN,Kempsey                         ,3076,1900,9,77,1176
26JWFP,Langland                        ,4558,2658,23,269,1900
26JWFQ,Laugherne Hill                  ,1731,1002,4,38,729
26JWFR,Leadon Vale                     ,1960,1062,3,80,898
26JWFS,Ledbury                         ,4281,2438,16,130,1843
26JWFT,Leigh and Bransford             ,1303,803,7,42,500
26JWFU,Link                            ,4449,2557,19,148,1892
26JWFW,Longdon                         ,1595,934,2,46,661
26JWFX,Marcle Ridge                    ,1345,860,11,64,485
26JWFY,Martley                         ,1439,890,7,45,549
26JWFZ,Morton                          ,1602,930,9,39,672
26JWGA,Powyke                          ,2606,1472,12,80,1134
26JWGB,Priory                          ,2052,1047,8,41,1005
26JWGC,Ripple                          ,1456,804,6,29,652
26JWGD,Temeside                        ,1218,753,4,39,465
26JWGE,The Hanleys                     ,1236,712,3,25,524
26JWGF,Trinity                         ,4696,2829,16,151,1867
26JWGG,Upton upon Severn               ,2105,1181,10,62,924
26JWGH,Wells                           ,2616,1619,8,67,997
26JWGJ,West                            ,2766,1833,17,110,933
26JWGK,Woodbury                        ,1534,959,16,42,575
26JWSS,Shipping                        ,0,0,0,0,0
26JXFA,Abbey                           ,4065,2796,25,206,1269
26JXFB,Batchley                        ,4544,2592,27,359,1952
26JXFC,Central                         ,5624,3620,50,296,2004
26JXFD,Church Hill                     ,5300,3757,46,289,1543
26JXFE,Crabbs Cross                    ,5343,3800,25,216,1543
26JXFF,Feckenham                       ,4620,3084,16,138,1536
26JXFG,Greenlands                      ,6923,5071,56,494,1852
26JXFH,Lodge Park                      ,5275,3682,37,342,1593
26JXFJ,Matchborough                    ,6557,4926,43,316,1631
26JXFK,West                            ,5742,3829,14,158,1913
26JXFL,Winyates                        ,5066,3750,40,294,1316
26JXSS,Shipping                        ,0,0,0,0,0
26JYFA,Backbury                        ,1700,996,13,57,704
26JYFB,Broad Oak                       ,1008,599,6,21,409
26JYFC,Burghill                        ,1050,627,6,43,423
26JYFD,Burmarsh                        ,1526,902,13,51,624
26JYFE,Dinedor Hill                    ,1027,681,10,29,346
26JYFF,Dinmore Hill                    ,1328,905,7,53,423
26JYFG,Doward                          ,1340,760,4,57,580
26JYFH,Fownhope                        ,936,509,6,34,427
26JYFJ,Garron                          ,959,611,10,33,348
26JYFK,Golden Valley                   ,1242,704,8,38,538
26JYFL,Gorsley                         ,1019,594,5,32,425
26JYFM,Gorsty                          ,2755,1853,19,85,902
26JYFN,Hagley                          ,1236,745,11,40,491
26JYFP,Harewood End                    ,1119,650,0,33,469
26JYFQ,Hollington                      ,0,0,0,0,0
26JYFR,Kingsthorne                     ,1035,577,9,33,458
26JYFS,Magna                           ,1636,1200,171,28,436
26JYFT,Merbach                         ,1061,631,3,31,430
26JYFU,Munstone                        ,1023,630,8,28,393
26JYFW,Olchon                          ,845,560,10,28,285
26JYFX,Old Gore                        ,937,588,3,38,349
26JYFY,Penyard                         ,1267,692,4,36,575
26JYFZ,Pontrilas                       ,1249,766,13,42,483
26JYGA,Ross-on-Wye East                ,3990,2251,26,141,1739
26JYGB,Ross-on-Wye West                ,3819,2408,22,175,1411
26JYGC,Stoney Street                   ,840,529,7,36,311
26JYGD,Swainshill                      ,1000,544,5,28,456
26JYGE,Thinghill                       ,980,598,9,50,382
26JYGF,Tram Inn                        ,968,582,4,31,386
26JYGG,Walford                         ,943,501,1,37,442
26JYGH,Whitfield                       ,928,586,6,49,342
26JYGJ,Wilton                          ,1086,579,5,27,507
26JYSS,Shipping                        ,0,0,0,0,0
26JZFA,All Saints                      ,4703,2977,41,376,1726
26JZFB,Bedwardine                      ,5497,3485,36,164,2012
26JZFC,Claines                         ,5625,3477,27,146,2148
26JZFD,Holy Trinity                    ,4752,3163,55,307,1589
26JZFE,Nunnery                         ,5258,3510,48,237,1748
26JZFF,St.Barnabas                     ,4577,2997,41,380,1580
26JZFG,St.Clement                      ,5832,3758,33,192,2074
26JZFH,St.John                         ,5262,3173,42,296,2089
26JZFJ,St.Martin                       ,6390,4499,47,420,1891
26JZFK,St.Nicholas                     ,4953,3265,37,280,1688
26JZFL,St.Peter                        ,7199,4749,33,219,2450
26JZFM,St.Stephen                      ,5160,3261,34,213,1899
26JZSS,Shipping                        ,0,0,0,0,0
26KAFA,Badsey                          ,2285,1487,15,54,798
26KAFB,Bowbrook                        ,1802,1144,6,56,658
26KAFC,Bredon                          ,2075,1197,5,44,878
26KAFD,Bretforton and Offenham         ,1866,1258,6,50,608
26KAFE,Broadway                        ,2405,1269,4,64,1136
26KAFF,Dodderhill                      ,1550,1027,7,55,523
26KAFG,Drakes Broughton                ,1963,1314,9,47,649
26KAFH,Droitwich Central               ,5323,3025,26,226,2298
26KAFJ,Droitwich South                 ,6394,4364,32,204,2030
26KAFK,Droitwich West                  ,4627,3260,43,306,1367
26KAFL,Eckington                       ,1993,1254,12,39,739
26KAFM,Elmley Castle                   ,1475,840,5,33,635
26KAFN,Evesham East                    ,1909,1200,4,77,709
26KAFP,Evesham Hampton                 ,3879,2342,9,138,1537
26KAFQ,Evesham North                   ,1894,1121,1,63,773
26KAFR,Evesham South                   ,4912,3486,20,151,1426
26KAFS,Evesham West                    ,1780,1124,8,66,656
26KAFT,Fladbury                        ,1615,995,3,49,620
26KAFU,Hanbury                         ,883,548,4,24,335
26KAFW,Hartlebury                      ,1845,1225,10,87,620
26KAFX,Harvington and Norton           ,2028,1294,12,73,734
26KAFY,Honeybourne and Pebworth        ,1673,1074,7,48,599
26KAFZ,Inkberrow                       ,2482,1558,7,56,924
26KAGA,Lenches                         ,914,551,2,22,363
26KAGB,Lovett                          ,1363,891,5,60,472
26KAGC,North Claines                   ,2368,1509,11,73,859
26KAGD,Ombersley                       ,1736,1053,5,51,683
26KAGE,Pershore Holy Cross             ,2947,1862,12,110,1085
26KAGF,Pershore St.Andrews             ,2818,1678,14,93,1140
26KAGG,Pinvin                          ,2087,1315,10,67,772
26KAGH,Somerville                      ,1517,964,5,46,553
26KAGJ,South Bredon Hill               ,1047,601,5,32,446
26KAGK,Spetchley                       ,1422,877,6,38,545
26KAGL,The Littletons                  ,2366,1504,5,73,862
26KAGM,Upton Snodsbury                 ,1653,983,7,33,670
26KAGN,Wickhamford                     ,1213,716,9,37,497
26KASS,Shipping                        ,0,0,0,0,0
26KBFA,Aggborough and Spennells        ,6528,4682,36,267,1846
26KBFB,Areley Kings                    ,5036,2987,38,295,2049
26KBFC,Bewdley                         ,4403,2800,28,181,1603
26KBFD,Blakedown                       ,1581,934,6,53,647
26KBFE,Broadwaters                     ,5149,3447,50,429,1702
26KBFF,Chaddesley                      ,1769,1097,16,45,672
26KBFG,Cookley                         ,2074,1239,11,89,835
26KBFH,Franche                         ,5922,4062,54,272,1860
26KBFJ,Greenhill                       ,5324,3565,42,322,1759
26KBFK,Habberley and Blakebrook        ,5370,3387,42,247,1983
26KBFL,Lickhill                        ,5688,3729,42,208,1959
26KBFM,Mitton                          ,4413,2812,25,244,1601
26KBFN,Offmore                         ,5037,3019,53,257,2018
26KBFP,Oldington and Foley Park        ,4702,2842,58,461,1860
26KBFQ,Rock and Ribbesford             ,2032,1256,14,72,776
26KBFR,Sutton Park                     ,5071,3265,41,317,1806
26KBFS,Wolverley                       ,1801,1060,10,83,741
26KBFT,Wribbenhall and Arley           ,4134,2478,19,153,1656
26KBSS,Shipping                        ,0,0,0,0,0
27KCFA,Broxbourne                      ,5775,3832,20,221,1943
27KCFB,Bury Green                      ,5711,3587,21,317,2124
27KCFC,Cheshunt Central                ,3853,2609,21,173,1244
27KCFD,Cheshunt North                  ,5672,3859,17,268,1813
27KCFE,Flamstead End                   ,5147,3560,10,224,1587
27KCFF,Goffs Oak                       ,3673,2450,16,148,1223
27KCFG,Hoddesdon North                 ,5204,3899,21,197,1305
27KCFH,Hoddesdon Town                  ,5102,3286,13,237,1816
27KCFJ,Rosedale                        ,2874,2002,15,148,872
27KCFK,Rye Park                        ,5219,3480,28,293,1739
27KCFL,Theobalds                       ,4221,2633,11,202,1588
27KCFM,Waltham Cross North             ,3363,2181,9,169,1182
27KCFN,Waltham Cross South             ,4448,2854,20,337,1594
27KCFP,Wormley And Turnford            ,4813,3403,16,343,1410
27KCSS,Shipping                        ,0,0,0,0,0
27KDFA,Adeyfield East                  ,3957,2399,16,162,1558
27KDFB,Adeyfield West                  ,4259,2555,30,187,1704
27KDFC,Aldbury and Wigginton           ,1854,1255,8,54,599
27KDFD,Ashridge                        ,2897,1764,4,77,1133
27KDFE,Bennetts End                    ,4473,2663,15,210,1810
27KDFF,Berkhamsted Central             ,4049,2728,8,108,1321
27KDFG,Berkhamsted East                ,4933,3253,17,204,1680
27KDFH,Berkhamsted West                ,3563,2154,14,136,1409
27KDFJ,Bovingdon and Flaunden          ,3810,2647,18,127,1163
27KDFK,Boxmoor                         ,5066,3295,12,168,1771
27KDFL,Central                         ,4016,2440,16,155,1576
27KDFM,Chaulden                        ,2347,1569,6,100,778
27KDFN,Chipperfield                    ,1390,860,1,36,530
27KDFP,Crabtree                        ,5147,3369,14,200,1778
27KDFQ,Cupid Green                     ,4892,4000,17,257,892
27KDFR,Flamstead and Markyate          ,3408,2253,5,115,1155
27KDFS,Gadebridge                      ,3443,2324,17,140,1119
27KDFT,Grove Hill                      ,5944,4542,32,357,1402
27KDFU,Highfield                       ,4720,3089,18,268,1631
27KDFW,Kings Langley                   ,3937,2517,13,100,1420
27KDFX,Leverstock Green                ,5448,3770,11,176,1678
27KDFY,Nash Mills                      ,1630,1037,6,66,593
27KDFZ,Northchurch                     ,2173,1276,7,74,897
27KDGA,South                           ,3077,2136,9,91,941
27KDGB,Tring Central                   ,3955,2694,20,155,1261
27KDGC,Tring East                      ,2125,1454,4,48,671
27KDGD,Tring West                      ,3844,2563,14,128,1281
27KDGE,Warners End                     ,4776,3113,16,199,1663
27KDSS,Shipping                        ,0,0,0,0,0
27KEFA,Bishop's Stortford Central      ,6757,4623,14,253,2134
27KEFB,Bishop's Stortford Chantry      ,5125,3263,9,151,1862
27KEFC,Bishop's Stortford Parsonage    ,4363,3042,16,161,1321
27KEFD,Bishop's Stortford Thorley      ,5731,4310,11,171,1421
27KEFE,Braughing                       ,1466,939,4,52,527
27KEFF,Buntingford                     ,3967,2688,13,138,1279
27KEFG,Cottered                        ,1419,860,4,48,559
27KEFH,Datchworth                      ,1233,788,1,37,445
27KEFJ,Great Amwell                    ,1552,1044,6,55,508
27KEFK,Hertford Bengeo                 ,5016,3405,12,166,1611
27KEFL,Hertford Castle                 ,6028,4219,22,246,1809
27KEFM,Hertford Kingsmead              ,4245,2894,9,147,1351
27KEFN,Hertford Sele                   ,2973,1878,14,152,1095
27KEFP,Hunsdon                         ,2100,1362,8,66,738
27KEFQ,Little Amwell                   ,2890,1918,6,89,972
27KEFR,Little Hadham                   ,1676,1063,9,65,613
27KEFS,Much Hadham                     ,2373,1450,5,67,923
27KEFT,Munden                          ,1032,677,3,46,355
27KEFU,Sawbridgeworth                  ,6391,4266,22,220,2125
27KEFW,Standon St.Mary                 ,2618,1815,7,84,803
27KEFX,Stanstead                       ,2134,1450,7,118,684
27KEFY,Stapleford                      ,1343,893,2,52,450
27KEFZ,Tewin                           ,1721,1124,4,60,597
27KEGA,Thundridge                      ,1232,835,7,30,397
27KEGB,Walkern                         ,2414,1646,7,95,768
27KEGC,Ware Christchurch               ,3802,2486,15,128,1316
27KEGD,Ware Priory                     ,3232,2251,5,94,981
27KEGE,Ware St.Mary's                  ,3766,2839,11,127,927
27KEGF,Ware Trinity                    ,2958,2014,12,173,944
27KEGG,Watton-at-Stone                 ,1648,1161,7,56,487
27KESS,Shipping                        ,0,0,0,0,0
27KFFA,Aldenham East                   ,3584,2226,7,125,1358
27KFFB,Aldenham West                   ,3406,2112,8,108,1294
27KFFC,Brookmeadow                     ,3040,1731,26,204,1309
27KFFD,Campions                        ,2319,1435,14,165,884
27KFFE,Cowley                          ,4574,2973,20,306,1601
27KFFF,Elstree                         ,4479,2930,9,196,1549
27KFFG,Heath North                     ,4124,2690,12,113,1434
27KFFH,Heath South                     ,4212,2666,12,124,1546
27KFFJ,Hillside                        ,3270,2073,12,200,1197
27KFFK,Kenilworth                      ,2963,1765,12,195,1198
27KFFL,Lyndhurst                       ,3362,2178,24,201,1184
27KFFM,Mill                            ,3512,2300,13,132,1212
27KFFN,Potters Bar Central             ,3170,2005,15,101,1165
27KFFP,Potters Bar East                ,4714,2853,17,170,1861
27KFFQ,Potters Bar North               ,3655,2154,7,90,1501
27KFFR,Potters Bar South               ,2902,1557,11,103,1345
27KFFS,Potters Bar West                ,3752,2491,18,128,1261
27KFFT,St.James East                   ,3304,2193,14,124,1111
27KFFU,St.James West                   ,3748,2462,5,115,1286
27KFFW,Shenley                         ,2276,1120,14,65,1156
27KFSS,Shipping                        ,0,0,0,0,0
27KGFA,Arbury                          ,1878,1214,5,49,664
27KGFB,Ashbrook                        ,2169,1272,4,67,897
27KGFC,Baldock                         ,7476,5114,13,376,2362
27KGFD,Bearton                         ,4941,3490,27,340,1451
27KGFE,Cadwell                         ,1895,1239,8,76,656
27KGFF,Codicote                        ,2497,1637,3,82,860
27KGFG,Grange                          ,5347,3360,17,267,1987
27KGFH,Highbury                        ,5244,3400,20,186,1844
27KGFJ,Hitchwood                       ,1412,833,2,44,579
27KGFK,Hoo                             ,1532,994,6,61,538
27KGFL,Kimpton                         ,1755,1168,3,70,587
27KGFM,Knebworth                       ,3493,2279,11,111,1214
27KGFN,Letchworth East                 ,5144,3306,19,359,1838
27KGFP,Letchworth South East           ,6385,4393,26,350,1992
27KGFQ,Letchworth South West           ,4812,2870,17,219,1942
27KGFR,Newsells                        ,1265,760,6,34,505
27KGFS,Offa                            ,1632,995,1,41,637
27KGFT,Oughton                         ,4151,2507,16,255,1644
27KGFU,Priory                          ,2888,1678,14,74,1210
27KGFW,Royston East                    ,4398,3111,20,136,1287
27KGFX,Royston West                    ,6457,4437,15,251,2020
27KGFY,Sandon                          ,1159,742,5,30,417
27KGFZ,Walsworth                       ,6298,4323,23,289,1975
27KGGA,Weston                          ,1293,834,3,37,459
27KGGB,Wilbury                         ,4060,2417,8,232,1643
27KGSS,Shipping                        ,0,0,0,0,0
27KHFA,Ashley                          ,5254,3739,17,196,1515
27KHFB,Batchwood                       ,4960,3186,22,173,1774
27KHFC,Clarence                        ,4391,2840,17,170,1551
27KHFD,Colney Heath                    ,3163,2019,15,98,1144
27KHFE,Cunningham                      ,5132,3350,24,224,1782
27KHFF,Harpenden East                  ,5081,3227,12,140,1854
27KHFG,Harpenden North                 ,5968,3813,17,187,2155
27KHFH,Harpenden South                 ,5304,3449,18,141,1855
27KHFJ,Harpenden West                  ,5190,2956,25,103,2234
27KHFK,London Colney                   ,6727,4212,44,234,2515
27KHFL,Marshalswick North              ,5029,3418,15,174,1611
27KHFM,Marshalswick South              ,5354,3446,16,167,1908
27KHFN,Park Street                     ,4984,2999,12,160,1985
27KHFP,Redbourn                        ,4572,2945,11,163,1627
27KHFQ,St.Peters                       ,5026,3480,30,281,1546
27KHFR,St.Stephens                     ,5924,3891,12,153,2033
27KHFS,Sandridge                       ,3912,2869,8,120,1043
27KHFT,Sopwell                         ,5313,3475,31,244,1838
27KHFU,Verulam                         ,5396,3524,16,133,1872
27KHFW,Wheathampstead                  ,4845,3082,28,155,1763
27KHSS,Shipping                        ,0,0,0,0,0
27KJFA,Bandley Hill                    ,6255,4456,44,406,1799
27KJFB,Bedwell Plash                   ,3914,2328,21,317,1586
27KJFC,Chells                          ,3302,2361,17,192,941
27KJFD,Longmeadow                      ,5076,3348,22,253,1728
27KJFE,Martins Wood                    ,5767,4314,30,304,1453
27KJFF,Mobbsbury                       ,3422,2363,16,170,1059
27KJFG,Monkswood                       ,2536,1445,5,157,1091
27KJFH,Old Stevenage                   ,5585,3473,26,237,2112
27KJFJ,Pin Green                       ,3911,2761,28,233,1150
27KJFK,Roebuck                         ,4201,2692,18,253,1509
27KJFL,St.Nicholas                     ,3646,2700,30,265,946
27KJFM,Shephall                        ,3418,2227,13,243,1191
27KJFN,Symonds Green                   ,5514,3729,39,263,1785
27KJFP,Wellfield                       ,1740,1356,7,127,384
27KJSS,Shipping                        ,0,0,0,0,0
27KKFA,Abbots Langley                  ,3588,2271,12,116,1317
27KKFB,Ashridge                        ,2714,1683,5,142,1031
27KKFC,Bedmond                         ,2561,1815,11,93,746
27KKFD,Carpenders Park                 ,4102,2623,12,156,1479
27KKFE,Chorleywood                     ,4311,2617,15,149,1694
27KKFF,Chorleywood West                ,4180,2457,6,107,1723
27KKFG,Croxley Green                   ,3410,2109,11,87,1301
27KKFH,Croxley Green North             ,2456,1414,8,59,1042
27KKFJ,Croxley Green South             ,2805,1887,5,75,918
27KKFK,Hayling                         ,3098,1628,13,175,1470
27KKFL,Langleybury                     ,2953,1804,9,111,1149
27KKFM,Leavesden                       ,4263,2671,26,142,1592
27KKFN,Maple Cross and West Hyde       ,2052,1377,4,89,675
27KKFP,Mill End                        ,2354,1567,6,124,787
27KKFQ,Money Hill                      ,2919,1808,11,99,1111
27KKFR,Moor Park                       ,3669,2148,17,82,1521
27KKFS,Northwick                       ,3784,2140,21,221,1644
27KKFT,Oxhey Hall                      ,2484,1690,10,89,794
27KKFU,Rickmansworth                   ,3506,2225,8,89,1281
27KKFW,Sarratt                         ,2138,1321,3,53,817
27KKSS,Shipping                        ,0,0,0,0,0
27KLFA,Callowland                      ,4306,3102,13,244,1204
27KLFB,Central                         ,4975,3554,36,401,1421
27KLFC,Holywell                        ,4470,3019,26,262,1451
27KLFD,Leggatts                        ,4368,2932,28,237,1436
27KLFE,Meriden                         ,5623,3600,33,267,2023
27KLFF,Nascot                          ,5142,3213,13,149,1929
27KLFG,Oxhey                           ,4957,3287,16,197,1670
27KLFH,Park                            ,4278,2701,15,113,1577
27KLFJ,Stanborough                     ,5097,3485,15,229,1612
27KLFK,Tudor                           ,5181,3696,12,169,1485
27KLFL,Vicarage                        ,5857,4185,34,334,1672
27KLFM,Woodside                        ,5179,3377,22,185,1802
27KLSS,Shipping                        ,0,0,0,0,0
27KMFA,Brookmans Park and Little Heath ,4268,2557,11,105,1711
27KMFB,Haldens                         ,9961,7190,45,444,2771
27KMFC,Handside                        ,4968,2806,20,155,2162
27KMFD,Hatfield Central                ,4563,2695,20,201,1868
27KMFE,Hatfield East                   ,5691,3777,44,279,1914
27KMFF,Hatfield North                  ,4612,2895,19,162,1717
27KMFG,Hatfield West                   ,5048,3257,17,205,1791
27KMFH,Hollybush                       ,4273,2591,15,200,1682
27KMFJ,Howlands                        ,4615,2991,22,171,1624
27KMFK,Northaw                         ,4422,2611,9,108,1811
27KMFL,Peartree                        ,4797,3101,19,347,1696
27KMFM,Sherrards                       ,4591,2960,9,173,1631
27KMFN,Welham Green and Redhall        ,5608,3664,9,200,1944
27KMFP,Welwyn East                     ,4370,2843,9,126,1527
27KMFQ,Welwyn West                     ,3080,1890,10,113,1190
27KMSS,Shipping                        ,0,0,0,0,0
28KNFA,Airmyn and Rawcliffe            ,2303,1353,27,101,950
28KNFB,Crowle                          ,2976,1744,26,133,1232
28KNFC,East Derwent                    ,1549,1007,19,51,542
28KNFD,East Howdenshire                ,1592,1072,11,45,520
28KNFE,Epworth and Belton              ,4732,2813,41,198,1919
28KNFF,Gilberdyke                      ,2324,1477,22,50,847
28KNFG,Goole Central and South         ,2550,1486,32,298,1064
28KNFH,Goole East                      ,2741,1662,51,210,1079
28KNFJ,Goole North                     ,4368,2629,47,219,1739
28KNFK,Goole North-East                ,2397,1406,42,208,991
28KNFL,Goole West                      ,2627,1611,42,147,1016
28KNFM,Haxey                           ,3612,2143,31,140,1469
28KNFN,Holme Upon Spalding Moor        ,2336,1469,8,48,867
28KNFP,Hook                            ,924,607,7,35,317
28KNFQ,Howden                          ,3362,2175,31,115,1187
28KNFR,Keadby with Althorpe            ,1362,809,12,80,553
28KNFS,Marshland                       ,1281,765,12,66,516
28KNFT,Mid Howdenshire                 ,1130,731,9,36,399
28KNFU,North Axholme                   ,1113,647,7,40,466
28KNFW,North Cave                      ,1402,877,11,29,525
28KNFX,Snaith                          ,3343,2167,29,149,1176
28KNFY,Trentside                       ,1475,882,10,65,593
28KNSS,Shipping                        ,0,0,0,0,0
28KPFA,Cleethorpes Alexandra           ,3808,2172,40,361,1636
28KPFB,Cleethorpes Beacon Hill         ,3248,1589,25,159,1659
28KPFC,Cleethorpes Central             ,3734,2242,33,225,1492
28KPFD,Cleethorpes Middlethorpe        ,2493,1555,33,100,938
28KPFE,Cleethorpes North               ,3583,2312,35,360,1271
28KPFF,Cleethorpes Riverside           ,4229,2539,32,161,1690
28KPFG,Cleethorpes Sidney              ,2778,1829,44,264,949
28KPFH,Cleethorpes Thrunscoe           ,3848,2238,39,195,1610
28KPFJ,Habrough and Stallingborough    ,1381,855,4,52,526
28KPFK,Healing                         ,1588,991,10,68,597
28KPFL,Humberston                      ,4654,2698,41,179,1956
28KPFM,Immingham Bluestone             ,2035,1382,17,128,653
28KPFN,Immingham Central               ,2642,1600,18,210,1042
28KPFP,Immingham Humber                ,3586,2169,32,402,1417
28KPFQ,Laceby                          ,2302,1453,17,81,849
28KPFR,New Waltham                     ,2982,1853,21,114,1129
28KPFS,Waltham                         ,4870,3000,34,140,1870
28KPFT,Wold Parishes                   ,1169,726,5,35,443
28KPSS,Shipping                        ,0,0,0,0,0
28KQFA,Battleburn                      ,1717,1170,8,61,547
28KQFB,Bridlington Bessingby           ,4238,2244,47,270,1994
28KQFC,Bridlington Hilderthorpe        ,4241,2388,40,289,1853
28KQFD,Bridlington Old Town East       ,3943,1925,27,150,2018
28KQFE,Bridlington Old Town West       ,4846,2503,48,322,2343
28KQFF,Bridlington Quay North          ,4831,2041,21,125,2790
28KQFG,Bridlington Quay South          ,4629,2396,51,428,2233
28KQFH,Coastal                         ,1279,680,6,56,599
28KQFJ,Driffield North                 ,4784,2856,23,144,1928
28KQFK,Driffield South                 ,3433,2147,13,109,1286
28KQFL,Garrowby                        ,1679,1111,10,31,568
28KQFM,Hutton Cranswick                ,1767,1101,6,31,666
28KQFN,Lowland                         ,1647,1048,10,47,599
28KQFP,Market Weighton                 ,3795,2422,31,86,1373
28KQFQ,Nafferton                       ,1842,1135,9,48,707
28KQFR,Pocklington                     ,5609,3394,25,137,2215
28KQFS,Roman                           ,1199,737,7,39,462
28KQFT,St.John                         ,1731,1048,15,42,683
28KQFU,Stamford Bridge                 ,2716,1663,10,71,1053
28KQFW,Vale                            ,1713,1137,12,41,576
28KQFX,Viking                          ,2603,1259,14,109,1344
28KQFY,Wilberfoss                      ,1730,1162,6,36,568
28KQFZ,Wold                            ,1320,835,7,47,485
28KQGA,Woodland                        ,1448,945,12,55,503
28KQSS,Shipping                        ,0,0,0,0,0
28KRFA,Anlaby                          ,4782,2662,35,190,2120
28KRFB,Brough                          ,5780,3620,35,138,2160
28KRFC,Castle                          ,3727,2148,35,121,1579
28KRFD,Cherry Holme                    ,1725,1103,21,43,622
28KRFE,Hessle East                     ,5307,3393,56,219,1914
28KRFF,Hessle West                     ,5739,3555,35,233,2184
28KRFG,Kirk Ella                       ,4664,2851,24,102,1813
28KRFH,Leconfield                      ,1839,1213,22,53,626
28KRFJ,Leven                           ,1628,1015,13,56,613
28KRFK,Mill Beck and Croxby            ,5377,3250,46,214,2127
28KRFL,Minster North                   ,2772,1602,28,193,1170
28KRFM,Minster South                   ,3816,2312,20,121,1504
28KRFN,Molescroft                      ,3388,2045,25,55,1343
28KRFP,Priory                          ,4281,2193,21,160,2088
28KRFQ,St.Mary's East                  ,4239,2678,35,183,1561
28KRFR,St.Mary's West                  ,3068,1766,15,98,1302
28KRFS,Skidby and Rowley               ,1705,1070,14,41,635
28KRFT,South Cave                      ,3913,2517,29,82,1396
28KRFU,Springfield                     ,5250,3724,65,186,1526
28KRFW,Swanland                        ,5663,3423,37,142,2240
28KRFX,Tickton                         ,1975,1358,16,86,617
28KRFY,Walkington                      ,1858,1167,14,29,691
28KRFZ,Willerby                        ,5052,3070,30,123,1982
28KRGA,Woodmansey                      ,3416,2324,28,98,1092
28KRSS,Shipping                        ,0,0,0,0,0
28KSFA,Abbey                           ,2960,1810,28,133,1150
28KSFB,Barton-Upon-Humber Bridge       ,3777,2260,47,190,1517
28KSFC,Barton-Upon-Humber Park         ,3662,2185,44,230,1477
28KSFD,Bottesford Central              ,3163,2126,29,97,1037
28KSFE,Bottesford East                 ,3313,2174,29,95,1139
28KSFF,Bottesford West                 ,2809,1875,19,95,934
28KSFG,Brigg                           ,4317,2445,35,246,1872
28KSFH,Broughton                       ,3575,2212,30,114,1363
28KSFJ,Burton Upon Stather             ,2201,1346,16,94,855
28KSFK,Goxhill                         ,1393,865,12,70,528
28KSFL,Gunness                         ,2765,1809,25,134,956
28KSFM,Humber                          ,1556,975,16,96,581
28KSFN,Kirton                          ,2312,1547,25,74,765
28KSFP,Messingham                      ,2489,1519,31,104,970
28KSFQ,North Ancholme                  ,1520,917,13,69,603
28KSFR,North West                      ,1576,953,16,67,623
28KSFS,Scawby                          ,2071,1214,11,70,857
28KSFT,South Ancholme                  ,2092,1330,24,103,762
28KSFU,Trentside                       ,1157,617,11,72,540
28KSFW,Ulceby                          ,1484,917,9,66,567
28KSFX,Winterton                       ,4664,2814,55,202,1850
28KSFY,Wold                            ,1322,770,9,61,552
28KSFZ,Wrawby                          ,1312,799,7,36,513
28KSSS,Shipping                        ,0,0,0,0,0
28KTFA,Alexandra                       ,3108,1790,22,253,1318
28KTFB,Bradley                         ,3085,1547,47,351,1538
28KTFC,Carnforth                       ,3089,1802,36,379,1287
28KTFD,Central                         ,3069,1688,25,225,1381
28KTFE,Clee                            ,3030,1807,23,138,1223
28KTFF,Cromwell                        ,3398,2270,39,210,1128
28KTFG,Gilbey                          ,3116,1904,38,277,1212
28KTFH,Grant Thorold                   ,3152,2025,34,271,1127
28KTFJ,Great Coates                    ,4356,3274,40,145,1082
28KTFK,Hainton                         ,3235,2105,55,421,1130
28KTFL,Humber                          ,2957,1606,51,350,1351
28KTFM,Little Coates                   ,3162,1908,30,224,1254
28KTFN,Nunsthorpe                      ,2737,1443,32,341,1294
28KTFP,Pelham                          ,1217,636,10,46,581
28KTFQ,Scartho                         ,3404,2066,22,122,1338
28KTFR,Springfield                     ,3338,1908,25,161,1430
28KTFS,Victoria                        ,3324,1484,43,470,1840
28KTFT,Weelsby                         ,3071,1722,33,209,1349
28KTFU,Wellow                          ,2754,1565,22,143,1189
28KTFW,West                            ,3893,2413,33,271,1480
28KTFX,Willows                         ,3878,2281,53,324,1597
28KTFY,Wintringham                     ,3539,2088,40,240,1451
28KTSS,Shipping                        ,0,0,0,0,0
28KUFA,Aldbrough                       ,1410,825,11,61,585
28KUFB,Bilton                          ,2231,1432,24,99,799
28KUFC,Brandesburton                   ,1503,886,9,41,617
28KUFD,Burstwick                       ,1012,702,7,41,310
28KUFE,Burton Pidsea                   ,1140,756,11,44,384
28KUFF,Easington                       ,1087,647,9,80,440
28KUFG,Hedon                           ,4767,3160,49,180,1607
28KUFH,Hornsea North                   ,4572,2384,34,162,2188
28KUFJ,Hornsea South                   ,1915,1028,15,91,887
28KUFK,Keyingham                       ,2446,1598,31,89,848
28KUFL,Patrington                      ,2068,1160,22,114,908
28KUFM,Paull                           ,1113,753,13,54,360
28KUFN,Preston North                   ,1709,1130,17,73,579
28KUFP,Roos                            ,1336,834,13,46,502
28KUFQ,Seaton                          ,1256,778,18,52,478
28KUFR,Skirlaugh                       ,1794,1152,17,48,642
28KUFS,Sproatley                       ,1556,1078,9,46,478
28KUFT,Thorngumbald                    ,2623,1830,35,91,793
28KUFU,Withernsea North                ,2312,1312,29,182,1000
28KUFW,Withernsea South                ,2767,1379,31,187,1388
28KUSS,SHIPPING                        ,0,0,0,0,0
28KWFA,Avenue                          ,10105,6286,116,762,3819
28KWFB,Beverley                        ,10596,6743,98,660,3853
28KWFC,Boothferry                      ,9914,5769,65,434,4145
28KWFD,Derringham                      ,10526,6153,85,541,4373
28KWFE,Drypool                         ,10543,6580,147,805,3963
28KWFF,Holderness                      ,9716,5924,138,735,3792
28KWFG,Ings                            ,9726,4746,131,726,4980
28KWFH,Longhill                        ,9083,4709,147,776,4374
28KWFJ,Marfleet                        ,8551,4451,177,995,4100
28KWFK,Myton                           ,9506,5090,141,1324,4416
28KWFL,Newington                       ,10307,6495,123,1049,3812
28KWFM,Newland                         ,9471,5624,76,360,3847
28KWFN,Noddle Hill                     ,10644,6001,226,1541,4643
28KWFP,Orchard Park                    ,10484,5671,245,1412,4813
28KWFQ,Pickering                       ,7454,4258,101,611,3196
28KWFR,St.Andrews                      ,8653,4868,127,1219,3785
28KWFS,Southcoates                     ,10294,6143,148,989,4151
28KWFT,Stoneferry                      ,11378,7564,153,902,3814
28KWFU,Sutton                          ,12554,7641,196,870,4913
28KWFW,University                      ,8925,4665,157,918,4260
28KWSS,Shipping                        ,0,0,0,0,0
28KXFA,Ashby Grange East               ,2449,1373,33,163,1076
28KXFB,Ashby Grange West               ,3484,1910,47,194,1574
28KXFC,Brumby East                     ,2784,1646,27,186,1138
28KXFD,Brumby West                     ,3925,2166,52,390,1759
28KXFE,Crosby Town North               ,3080,1791,33,316,1289
28KXFF,Crosby Town South               ,2978,1636,33,357,1342
28KXFG,Frodingham North                ,3696,2239,57,211,1457
28KXFH,Frodingham South                ,1958,1005,22,141,953
28KXFJ,Kingsway East                   ,2348,1308,20,92,1040
28KXFK,Kingsway West                   ,3463,2211,36,176,1252
28KXFL,Lincoln Gardens East            ,2173,1243,38,185,930
28KXFM,Lincoln Gardens West            ,3360,1610,27,170,1750
28KXFN,Park East                       ,3783,2113,54,347,1670
28KXFP,Park West                       ,2365,1595,17,97,770
28KXFQ,Riddings East                   ,2389,1426,24,133,963
28KXFR,Riddings West                   ,3545,2124,43,293,1421
28KXSS,Shipping                        ,0,0,0,0,0
29KYFA,Cowes Castle                    ,3088,1606,21,133,1482
29KYFB,Cowes Central                   ,1936,1197,19,129,739
29KYFC,Cowes Medina                    ,2543,1486,26,169,1057
29KYFD,Cowes Northwood                 ,3080,1726,16,128,1354
29KYFE,East Cowes                      ,3089,1849,26,157,1240
29KYFF,Newport Carisbrooke             ,4036,2575,24,125,1461
29KYFG,Newport Central                 ,1493,873,14,97,620
29KYFH,Newport Mount Joy               ,2574,1415,21,156,1159
29KYFJ,Newport Pan                     ,3461,1969,26,253,1492
29KYFK,Newport Parkhurst               ,3482,1833,44,151,1649
29KYFL,Newport Wootton and Fairlee     ,5099,2797,32,178,2302
29KYFM,Osborne                         ,2417,1203,18,140,1214
29KYFN,Ryde Ashey and Binstead         ,4687,2622,23,177,2065
29KYFP,Ryde East                       ,4661,2634,39,348,2027
29KYFQ,Ryde St. Helens                 ,3365,1550,15,115,1815
29KYFR,Ryde St. Johns                  ,4053,2098,20,289,1955
29KYFS,Ryde West                       ,4796,2454,35,282,2342
29KYSS,Shipping                        ,0,0,0,0,0
29KZFA,Arreton and Newchurch           ,2765,1685,18,112,1080
29KZFB,Bembridge                       ,3045,1310,12,97,1735
29KZFC,Brading                         ,1660,812,12,89,848
29KZFD,Brightstone and Shorwell        ,2019,1013,13,50,1006
29KZFE,Calbourne and Shalfleet         ,1942,1085,8,72,857
29KZFF,Chale and Niton                 ,2282,1120,17,118,1162
29KZFG,Freshwater                      ,5190,2359,27,221,2831
29KZFH,Gatcombe and Godshill           ,2067,1210,26,95,857
29KZFJ,Lake                            ,3731,1737,15,193,1994
29KZFK,Sandown                         ,4407,2465,37,346,1942
29KZFL,Shanklin North                  ,3457,1760,24,216,1697
29KZFM,Shanklin South                  ,3319,1710,15,224,1609
29KZFN,Totland                         ,2247,1011,21,101,1236
29KZFP,Ventnor                         ,4979,2442,28,316,2537
29KZFQ,Wroxall                         ,1285,679,12,65,606
29KZFR,Yarmouth                        ,0,0,0,0,0
29KZSS,Shipping                        ,0,0,0,0,0
30LCFA,Aldington                       ,1198,709,5,40,489
30LCFB,Appledore                       ,0,0,0,0,0
30LCFC,Ashford Bockhanger              ,2364,1473,18,145,891
30LCFD,Ashford Brookfield              ,1527,944,8,117,583
30LCFE,Ashford Bybrook                 ,1438,916,13,51,522
30LCFF,Ashford Central                 ,3053,2196,20,133,857
30LCFG,Ashford Eastmead                ,1657,1157,9,76,500
30LCFH,Ashford Hampden                 ,1228,747,10,106,481
30LCFJ,Ashford Henwood                 ,1247,788,7,41,459
30LCFK,Ashford Kennington Lees         ,1652,1058,10,76,594
30LCFL,Ashford Musgrove                ,1375,851,7,89,524
30LCFM,Ashford Queens                  ,1480,977,11,107,503
30LCFN,Ashford Singleton               ,2274,1767,15,125,507
30LCFP,Ashford South Willesborough     ,2280,1468,13,139,812
30LCFQ,Ashford Spearpoint              ,1316,793,8,38,523
30LCFR,Ashford Twelve Acres            ,1422,815,9,94,607
30LCFS,Ashford Victoria Park           ,1333,897,5,74,436
30LCFT,Ashford Warren                  ,1502,991,5,39,511
30LCFU,Ashford Waterside               ,1241,817,6,59,424
30LCFW,Ashford Willesborough Lees      ,2875,2101,14,72,774
30LCFX,Ashford Windmill                ,1380,974,1,32,406
30LCFY,Ashford Woolreeds               ,1347,729,10,77,618
30LCFZ,Bethersden                      ,1082,628,4,49,454
30LCGA,Biddenden                       ,1845,1081,7,76,764
30LCGB,Boughton Aluph                  ,1428,891,7,46,537
30LCGC,Brabourne                       ,1523,1011,2,51,512
30LCGD,Charing                         ,2290,1183,9,79,1107
30LCGE,Chilham                         ,1704,991,4,42,713
30LCGF,Great Chart                     ,2068,1489,13,95,579
30LCGG,Hamstreet                       ,1781,1098,5,64,683
30LCGH,High Halden                     ,1123,707,7,44,416
30LCGJ,Hothfield                       ,1295,757,7,74,538
30LCGK,Kingsnorth                      ,2922,2072,12,134,850
30LCGL,Mersham                         ,1736,1068,3,49,668
30LCGM,Pluckley                        ,927,566,3,31,361
30LCGN,Rolvenden                       ,1368,808,4,30,560
30LCGP,Smarden                         ,1699,1036,7,42,663
30LCGQ,Stanhope                        ,2728,1750,22,340,978
30LCGR,Tenterden East                  ,1528,712,1,36,816
30LCGS,Tenterden St.Michaels           ,1790,1007,3,60,783
30LCGT,Tenterden South East            ,1351,745,5,55,606
30LCGU,Tenterden West                  ,1140,585,2,35,555
30LCGW,Wittersham                      ,1919,1157,13,77,762
30LCGX,Woodchurch                      ,1464,804,5,46,660
30LCGY,Wye                             ,1672,773,5,50,899
30LCSS,Shipping                        ,0,0,0,0,0
30LDFA,Barham Downs                    ,2224,1270,5,63,954
30LDFB,Barton                          ,5555,2829,25,225,2726
30LDFC,Blean Forest                    ,1895,1019,7,48,876
30LDFD,Chartham                        ,2346,1491,12,92,855
30LDFE,Chestfield                      ,4437,2372,16,157,2065
30LDFF,Gorrell                         ,4278,2391,17,188,1887
30LDFG,Harbledown                      ,1747,1008,5,41,739
30LDFH,Harbour                         ,3646,2178,17,272,1468
30LDFJ,Herne                           ,8351,4674,21,334,3677
30LDFK,Heron                           ,6043,3096,25,371,2947
30LDFL,Little Stour                    ,1858,1062,6,61,796
30LDFM,Marshside                       ,2076,1244,9,107,832
30LDFN,Northgate                       ,5920,3524,34,412,2396
30LDFP,North Nailbourne                ,2091,1256,2,70,835
30LDFQ,Reculver                        ,7288,3418,30,265,3870
30LDFR,St.Stephens                     ,6478,3971,39,283,2507
30LDFS,Seasalter                       ,5400,2767,25,219,2633
30LDFT,Stone Street                    ,1582,977,3,45,605
30LDFU,Sturry North                    ,1978,1216,19,120,762
30LDFW,Sturry South                    ,2614,1619,10,82,995
30LDFX,Swalecliffe                     ,3017,1275,8,101,1742
30LDFY,Tankerton                       ,3327,1600,10,134,1727
30LDFZ,West Bay                        ,5084,2278,17,228,2806
30LDGA,Westgate                        ,6326,3570,19,246,2756
30LDGB,Wincheap                        ,5271,3205,30,312,2066
30LDSS,Shipping                        ,0,0,0,0,0
30LEFA,Bean                            ,1334,947,8,79,387
30LEFB,Brent                           ,4082,2846,12,147,1236
30LEFC,Darenth                         ,2998,1964,14,170,1034
30LEFD,Galley Hill                     ,2366,1512,16,187,854
30LEFE,Greenhithe                      ,2665,1930,9,145,735
30LEFF,Gundulf                         ,3394,2325,9,115,1069
30LEFG,Heath                           ,4213,2768,17,127,1445
30LEFH,Horns Cross                     ,1133,739,6,55,394
30LEFJ,Joyce Green                     ,2578,1323,20,140,1255
30LEFK,Littlebrook                     ,3159,2096,15,210,1063
30LEFL,Longfield                       ,4037,2565,14,112,1472
30LEFM,Maypole                         ,3091,1964,21,114,1127
30LEFN,Miskin                          ,2298,1520,8,76,778
30LEFP,Newtown                         ,3797,2679,16,172,1118
30LEFQ,Princes                         ,4180,2536,26,270,1644
30LEFR,Priory                          ,1605,1213,13,65,392
30LEFS,Southfleet                      ,1029,660,3,46,369
30LEFT,Stone                           ,4706,3115,22,231,1591
30LEFU,Sutton-at-Hone and Hawley       ,3323,2129,13,125,1194
30LEFW,Swanscombe                      ,2365,1459,17,171,906
30LEFX,Wilmington Central              ,1804,1134,3,60,670
30LEFY,Wilmington East                 ,1363,848,4,42,515
30LEFZ,Wilmington West                 ,2489,1541,4,62,948
30LESS,Shipping                        ,0,0,0,0,0
30LFFA,Ash                             ,2226,1335,9,82,891
30LFFB,Aylesham                        ,3090,1938,23,246,1152
30LFFC,Barton                          ,3253,2040,17,130,1213
30LFFD,Buckland                        ,3573,2238,17,244,1335
30LFFE,Capel-le-Ferne                  ,2484,1432,8,156,1052
30LFFF,Castle                          ,2574,1342,8,150,1232
30LFFG,Cornilo                         ,1600,973,7,87,627
30LFFH,Eastry                          ,1847,1021,12,75,826
30LFFJ,Eythorne                        ,1861,1132,11,92,729
30LFFK,Little Stour                    ,1988,1171,6,54,817
30LFFL,Lower Walmer                    ,4172,2130,31,149,2042
30LFFM,Lydden and Temple Ewell         ,2002,1227,8,53,775
30LFFN,Maxton and Elms Vale            ,3006,1989,14,83,1017
30LFFP,Middle Deal                     ,5110,2865,39,258,2245
30LFFQ,Mill Hill                       ,2999,1715,19,153,1284
30LFFR,Mongeham                        ,3182,1787,21,185,1395
30LFFS,Noninstone                      ,1154,681,1,39,473
30LFFT,North Deal                      ,4986,2762,26,268,2224
30LFFU,Pineham                         ,4800,3226,24,142,1574
30LFFW,Priory                          ,2816,1950,19,182,866
30LFFX,Ringwould                       ,1618,829,3,46,789
30LFFY,River                           ,2982,1805,8,68,1177
30LFFZ,St.Margaret's at Cliffe         ,2471,1348,16,78,1123
30LFGA,St.Radigunds                    ,2464,1431,13,188,1033
30LFGB,Sandwich                        ,3928,2122,12,123,1806
30LFGC,Shepherdswell with Coldred      ,1744,1022,8,52,722
30LFGD,Tower Hamlets                   ,2987,1823,20,206,1164
30LFGE,Town and Pier                   ,1700,915,12,75,785
30LFGF,Upper Walmer                    ,2025,981,6,71,1044
30LFGG,Woodnesborough with Staple      ,1165,724,4,37,441
30LFGH,Worth                           ,1411,779,3,52,632
30LFSS,Shipping                        ,0,0,0,0,0
30LGFA,Beechings                       ,4768,2846,50,398,1922
30LGFB,Brompton                        ,4954,3264,49,382,1690
30LGFC,Hempstead and Wigmore           ,7232,5001,30,229,2231
30LGFD,Medway                          ,5157,3240,42,399,1917
30LGFE,North                           ,4537,2992,32,385,1545
30LGFF,Park Wood                       ,6190,4544,39,263,1646
30LGFG,Priestfield                     ,4915,3166,35,364,1749
30LGFH,Rainham                         ,4660,3032,31,250,1628
30LGFJ,Rainham Mark                    ,6122,3919,30,218,2203
30LGFK,Riverside                       ,4774,3169,22,232,1605
30LGFL,St.Margaret's                   ,6705,4688,45,262,2017
30LGFM,South                           ,4210,2760,23,352,1450
30LGFN,Twydall                         ,4492,2529,27,258,1963
30LGFP,Watling Street                  ,4789,3011,32,223,1778
30LGSS,Shipping                        ,0,0,0,0,0
30LHFA,Central                         ,3585,2256,12,262,1329
30LHFB,Chalk                           ,2094,1370,8,86,724
30LHFC,Cobham and Luddesdown           ,1305,794,5,45,511
30LHFD,Coldharbour                     ,3457,2097,21,257,1360
30LHFE,Higham                          ,3228,1988,16,123,1240
30LHFF,Istead                          ,3068,2049,13,105,1019
30LHFG,Meopham North                   ,3683,2378,14,135,1305
30LHFH,Meopham South                   ,3282,2311,12,166,971
30LHFJ,Northfleet East                 ,4580,2846,18,322,1734
30LHFK,Northfleet West                 ,4943,2905,30,362,2038
30LHFL,Painters Ash                    ,3964,2548,27,168,1416
30LHFM,Pelham                          ,4883,3164,44,406,1719
30LHFN,Riverside                       ,4406,2642,21,454,1764
30LHFP,Riverview                       ,5244,3640,29,246,1604
30LHFQ,Shorne                          ,1833,1108,11,66,725
30LHFR,Singlewell                      ,4739,2888,23,330,1851
30LHFS,Westcourt                       ,4511,2680,41,423,1831
30LHFT,Whitehill                       ,5044,3087,24,296,1957
30LHFU,Woodlands                       ,5447,3419,24,265,2028
30LHSS,Shipping                        ,0,0,0,0,0
30LJFA,Allington                       ,5186,3124,20,138,2062
30LJFB,Barming                         ,1968,1278,8,48,690
30LJFC,Bearsted                        ,4986,2890,9,95,2096
30LJFD,Boughton Monchelsea             ,2065,1364,11,56,701
30LJFE,Boxley                          ,6384,4841,22,205,1543
30LJFF,Bridge                          ,6573,4485,19,310,2088
30LJFG,Coxheath                        ,3167,1979,12,92,1188
30LJFH,Detling                         ,1515,916,5,55,599
30LJFJ,East                            ,6096,3945,31,190,2151
30LJFK,Farleigh                        ,1441,870,1,54,571
30LJFL,Harrietsham and Lenham          ,3903,2437,17,160,1466
30LJFM,Headcorn                        ,3467,2116,9,132,1351
30LJFN,Heath                           ,6037,3820,32,223,2217
30LJFP,High Street                     ,4810,3044,37,268,1766
30LJFQ,Hollingbourne                   ,1169,761,3,42,408
30LJFR,Langley                         ,3097,2297,10,93,800
30LJFS,Leeds                           ,1953,1285,8,55,668
30LJFT,Loose                           ,1959,1228,8,54,731
30LJFU,Marden                          ,3800,2458,8,161,1342
30LJFW,North                           ,6223,4013,30,247,2210
30LJFX,Park Wood                       ,5396,3311,36,306,2085
30LJFY,Shepway East                    ,5010,2940,19,326,2070
30LJFZ,Shepway West                    ,4794,2971,22,272,1823
30LJGA,South                           ,6996,4785,32,323,2211
30LJGB,Staplehurst                     ,4464,2951,24,126,1513
30LJGC,Sutton Valence                  ,1343,831,5,44,512
30LJGD,Thurnham                        ,2068,1402,2,51,666
30LJGE,Yalding                         ,2972,1897,17,132,1075
30LJSS,Shipping                        ,0,0,0,0,0
30LKFA,All Saints                      ,3438,2186,13,252,1252
30LKFB,Cuxton and Halling              ,3761,2536,14,165,1225
30LKFC,Earl                            ,4864,2949,39,335,1915
30LKFD,Frindsbury                      ,5867,3789,31,357,2078
30LKFE,Frindsbury Extra                ,4196,2718,17,160,1478
30LKFF,Holcombe                        ,6828,4289,55,663,2539
30LKFG,Hoo St.Werburgh                 ,5797,3736,47,268,2061
30LKFH,Horsted                         ,5855,3820,28,204,2035
30LKFJ,Lordswood                       ,8785,6386,56,444,2399
30LKFK,Luton                           ,6426,4137,47,535,2289
30LKFL,Rede Court                      ,3958,2583,23,116,1375
30LKFM,St.Margarets and Borstal        ,5873,3673,35,317,2200
30LKFN,Temple Farm                     ,6265,4311,42,401,1954
30LKFP,Thames Side                     ,5295,3605,25,228,1690
30LKFQ,Town                            ,6890,4319,56,676,2571
30LKFR,Troy Town                       ,4827,2896,18,377,1931
30LKFS,Walderslade                     ,9766,7348,81,575,2418
30LKFT,Warren Wood                     ,5162,3100,33,295,2062
30LKFU,Wayfield                        ,4544,2909,23,288,1635
30LKFW,Weedswood                       ,4652,2964,37,318,1688
30LKSS,Shipping                        ,0,0,0,0,0
30LLFA,Ash-cum-Ridley                  ,5389,3952,25,227,1437
30LLFB,Brasted                         ,1108,638,2,29,470
30LLFC,Chevening                       ,2328,1402,6,58,926
30LLFD,Crockenhill                     ,1307,785,10,53,522
30LLFE,Dunton Green                    ,1295,826,6,61,469
30LLFF,Edenbridge North                ,2585,1735,11,81,850
30LLFG,Edenbridge South                ,3518,2255,10,133,1263
30LLFH,Eynsford                        ,1491,895,5,31,596
30LLFJ,Farningham                      ,1120,745,1,41,375
30LLFK,Fawkham and Hartley             ,5002,3101,17,192,1901
30LLFL,Halstead Knockholt and Badgers M,2802,1762,11,82,1040
30LLFM,Hextable and Swanley Village    ,3705,2534,21,120,1171
30LLFN,Horton Kirby                    ,2372,1511,5,117,861
30LLFP,Kemsing                         ,3205,2002,6,100,1203
30LLFQ,Leigh                           ,1184,722,2,22,462
30LLFR,Otford                          ,2681,1540,9,94,1141
30LLFS,Penshurst and Fordcombe         ,1283,713,3,45,570
30LLFT,Riverhead                       ,1525,850,0,40,675
30LLFU,Seal                            ,1653,973,5,49,680
30LLFW,Sevenoaks Kippington            ,3690,2026,4,99,1664
30LLFX,Sevenoaks Northern              ,3249,2037,7,120,1212
30LLFY,Sevenoaks Town and St.John's    ,4628,2614,9,136,2014
30LLFZ,Sevenoaks Weald and Underriver  ,1200,712,0,36,488
30LLGA,Sevenoaks Wildernesse           ,3196,1942,10,119,1254
30LLGB,Shoreham                        ,1164,711,1,32,453
30LLGC,Somerden                        ,2397,1469,3,77,928
30LLGD,Sundridge and Ide Hill          ,1556,871,0,58,685
30LLGE,Swanley Christchurch            ,4335,3122,19,170,1213
30LLGF,Swanley St.Mary's               ,3366,2101,20,237,1265
30LLGG,Swanley White Oak               ,5089,3384,30,285,1705
30LLGH,Westerham and Crockham Hill     ,3267,2118,13,119,1149
30LLGJ,West Kingsdown                  ,4440,2967,32,216,1473
30LLSS,Shipping                        ,0,0,0,0,0
30LMFA,Dymchurch and Burmarsh          ,3098,1575,11,135,1523
30LMFB,Elham                           ,1167,625,2,38,542
30LMFC,Folkestone Central              ,3548,1983,19,350,1565
30LMFD,Folkestone Cheriton             ,4666,2865,32,213,1801
30LMFE,Folkestone East                 ,3619,2098,27,309,1521
30LMFF,Folkestone Foord                ,4065,2595,21,298,1470
30LMFG,Folkestone Harbour              ,4018,2397,13,302,1621
30LMFH,Folkestone Harvey               ,4280,1889,24,215,2391
30LMFJ,Folkestone Morehall             ,3964,2472,20,177,1492
30LMFK,Folkestone Park                 ,5029,3116,28,192,1913
30LMFL,Folkestone Sandgate             ,3618,2021,12,155,1597
30LMFM,Hawkinge and Paddlesworth       ,1666,1018,15,104,648
30LMFN,Hythe East                      ,3186,1623,14,100,1563
30LMFP,Hythe North                     ,2537,1169,7,77,1368
30LMFQ,Hythe South                     ,2609,1205,7,113,1404
30LMFR,Hythe West                      ,3087,1659,17,132,1428
30LMFS,Lydd                            ,4197,2435,21,236,1762
30LMFT,Lympne and Stanford             ,1336,839,3,33,497
30LMFU,Marsh                           ,1236,717,14,57,519
30LMFW,New Romney                      ,5017,2800,26,197,2217
30LMFX,St.Mary in the Marsh            ,2327,1074,8,119,1253
30LMFY,Saltwood and Newington          ,924,506,2,38,418
30LMFZ,Sellindge                       ,1340,794,1,35,546
30LMGA,Stone Street                    ,2891,1609,11,86,1282
30LMGB,Swingfield and Acrise           ,1077,637,4,36,440
30LMSS,Shipping                        ,0,0,0,0,0
30LNFA,Abbey                           ,3071,1775,8,132,1296
30LNFB,Borden                          ,2031,1293,11,75,738
30LNFC,Boughton                        ,1470,941,2,77,529
30LNFD,Courtenay                       ,1747,1075,8,75,672
30LNFE,Davington Priory                ,2932,1809,14,195,1123
30LNFF,East Downs                      ,2477,1503,4,93,974
30LNFG,Eastern                         ,4050,2124,20,303,1926
30LNFH,Grove                           ,5354,3555,25,236,1799
30LNFJ,Hartlip and Upchurch            ,2099,1322,6,80,777
30LNFK,Iwade and Lower Halstow         ,1665,1177,12,85,488
30LNFL,Kemsley                         ,2569,1847,16,165,722
30LNFM,Milton Regis                    ,4487,2924,33,342,1563
30LNFN,Minster Cliffs                  ,5092,3170,40,259,1922
30LNFP,Murston                         ,5139,3415,41,397,1724
30LNFQ,Newington                       ,1984,1267,8,93,717
30LNFR,Queenborough and Halfway        ,5767,3475,37,332,2292
30LNFS,Roman                           ,5816,3565,63,286,2251
30LNFT,St.Ann's                        ,4336,2793,27,224,1543
30LNFU,Sheerness East                  ,3963,2475,21,354,1488
30LNFW,Sheerness West                  ,4920,2679,41,487,2241
30LNFX,Sheppey Central                 ,3651,2168,19,195,1483
30LNFY,Teynham and Lynsted             ,4366,2785,27,213,1581
30LNFZ,Watling                         ,3280,2007,20,118,1273
30LNGA,West Downs                      ,2186,1392,12,100,794
30LNGB,Woodstock                       ,6390,3879,40,257,2511
30LNSS,Shipping                        ,0,0,0,0,0
30LPFA,Beacon Road                     ,3417,1822,27,181,1595
30LPFB,Birchington East                ,5077,2006,15,205,3071
30LPFC,Birchington West                ,3352,1272,17,112,2080
30LPFD,Bradstowe                       ,3309,1450,15,106,1859
30LPFE,Cecil                           ,1778,1064,18,148,714
30LPFF,Central Eastcliff               ,5277,2917,35,525,2360
30LPFG,Central Westcliff               ,6119,3565,46,494,2554
30LPFH,Cliftonville                    ,6257,2872,34,389,3385
30LPFJ,Dane Park                       ,3744,2030,44,243,1714
30LPFK,Ethelbert                       ,1722,1121,20,222,601
30LPFL,Kingsgate                       ,1846,856,6,55,990
30LPFM,Margate West                    ,5313,2931,35,302,2382
30LPFN,Marine                          ,1780,1104,19,149,676
30LPFP,Minster Parish                  ,2661,1575,16,94,1086
30LPFQ,Newington                       ,3656,2193,63,359,1463
30LPFR,Northdown Park                  ,4473,2398,53,401,2075
30LPFS,Northwood                       ,5241,2821,33,337,2420
30LPFT,Pier                            ,2126,1105,20,266,1021
30LPFU,Pierremont                      ,2854,1315,9,134,1539
30LPFW,St.Lawrence                     ,3600,1863,28,141,1737
30LPFX,St.Peters                       ,4806,2535,24,180,2271
30LPFY,Salmestone                      ,3757,2144,25,198,1613
30LPFZ,Sir Moses Montefiore            ,2935,1719,14,155,1216
30LPGA,Southwood                       ,3884,2078,12,182,1806
30LPGB,Thanet Parishes                 ,1493,876,5,48,617
30LPGC,Upton                           ,4499,2373,24,204,2126
30LPGD,Westgate-on-Sea                 ,5702,2829,30,244,2873
30LPSS,Shipping                        ,0,0,0,0,0
30LQFA,Aylesford and Eccles            ,4485,2897,21,161,1588
30LQFB,BirlingRyarsh and Leybourne     ,4066,2693,11,153,1373
30LQFC,Blue Bell Hill                  ,3143,2229,11,104,914
30LQFD,Borough Green                   ,2693,1742,8,106,951
30LQFE,Burham and Wouldham             ,1792,1225,11,82,567
30LQFF,Cage Green                      ,3490,2109,6,124,1381
30LQFG,Castle                          ,3374,2090,7,104,1284
30LQFH,Ditton                          ,3874,2722,27,120,1152
30LQFJ,East Malling                    ,3207,1981,26,214,1226
30LQFK,East Peckham                    ,2644,1813,13,114,831
30LQFL,Hadlow                          ,2794,1799,8,98,995
30LQFM,Higham                          ,4073,2407,9,115,1666
30LQFN,Hildenborough                   ,3959,2238,11,106,1721
30LQFP,Ightham                         ,1437,877,1,41,560
30LQFQ,Judd                            ,3577,2413,17,128,1164
30LQFR,Larkfield                       ,6527,4721,20,234,1806
30LQFS,Medway                          ,2779,1724,14,122,1055
30LQFT,Mereworth and West Peckham      ,1190,785,3,61,405
30LQFU,Oast                            ,1985,1254,9,68,731
30LQFW,Platt                           ,1131,671,2,34,460
30LQFX,Plaxtol and Shipbourne          ,1125,638,0,33,487
30LQFY,Snodland                        ,5582,3889,32,226,1693
30LQFZ,Trench                          ,4004,2729,18,194,1275
30LQGA,Vauxhall                        ,3415,2416,14,105,999
30LQGB,Wateringbury                    ,1370,919,2,40,451
30LQGC,West Malling                    ,2077,1146,5,66,931
30LQGD,Wrotham                         ,1433,906,6,63,527
30LQSS,Shipping                        ,0,0,0,0,0
30LRFA,Benenden                        ,1376,820,1,42,556
30LRFB,Brenchley                       ,2230,1418,6,79,812
30LRFC,Capel                           ,1767,1226,2,63,541
30LRFD,Cranbrook                       ,3712,2315,19,129,1397
30LRFE,Culverden                       ,4591,2902,16,164,1689
30LRFF,Frittenden and Sissinghurst     ,1668,1050,4,66,618
30LRFG,Goudhurst                       ,2059,1278,2,58,781
30LRFH,Hawkhurst                       ,3437,2092,12,134,1345
30LRFJ,Horsmonden                      ,1548,995,12,66,553
30LRFK,Lamberhurst                     ,1140,731,3,34,409
30LRFL,Paddock Wood                    ,5569,3843,19,228,1726
30LRFM,Pantiles                        ,4025,2501,13,156,1524
30LRFN,Park                            ,4435,2531,15,156,1904
30LRFP,Pembury                         ,4850,3216,23,143,1634
30LRFQ,Rusthall                        ,4737,2847,20,172,1890
30LRFR,St.James'                       ,4637,3015,23,184,1622
30LRFS,St.John's                       ,4988,3456,10,177,1532
30LRFT,St.Mark's                       ,4347,2458,4,158,1889
30LRFU,Sandhurst                       ,1063,640,3,41,423
30LRFW,Sherwood                        ,5325,3483,12,257,1842
30LRFX,Southborough East               ,2700,1763,10,93,937
30LRFY,Southborough North              ,3565,2032,11,116,1533
30LRFZ,Southborough West               ,2373,1606,5,77,767
30LRGA,Speldhurst and Bidborough       ,4591,2616,8,114,1975
30LRSS,Shipping                        ,0,0,0,0,0
31LSFA,Bank Top                        ,4612,2327,60,500,2285
31LSFB,Billinge                        ,6002,3458,37,258,2544
31LSFC,Brookhouse                      ,4841,2325,79,685,2516
31LSFD,Brownhill                       ,5828,3275,25,291,2553
31LSFE,Cathedral                       ,3493,1856,54,364,1637
31LSFF,Earcroft                        ,5066,3058,38,269,2008
31LSFG,Ewood                           ,5690,3631,56,326,2059
31LSFH,Green Bank                      ,4764,2214,55,410,2550
31LSFJ,Higher Croft                    ,3737,2040,66,540,1697
31LSFK,Marsh House                     ,5601,3985,34,197,1616
31LSFL,Mill Hill                       ,4910,2996,34,300,1914
31LSFM,Moorgate                        ,5537,3548,48,308,1989
31LSFN,North Turton                    ,2858,1862,8,75,996
31LSFP,Pleckgate                       ,5680,3399,61,352,2281
31LSFQ,Queen's Park                    ,4819,2627,76,539,2192
31LSFR,Revidge                         ,5957,3570,54,323,2387
31LSFS,Shadsworth                      ,4394,2587,35,445,1807
31LSFT,Sudell                          ,5471,3344,41,349,2127
31LSFU,Sunnyhurst                      ,4990,3274,29,270,1716
31LSFW,West Rural                      ,5719,3688,28,145,2031
31LSFX,Whitehall                       ,3545,2225,25,135,1320
31LSSS,Shipping                        ,0,0,0,0,0
31LTFA,Alexandra                       ,5220,3412,65,630,1808
31LTFB,Anchorsholme                    ,5952,2812,27,193,3140
31LTFC,Bispham                         ,5684,2881,36,242,2803
31LTFD,Brunswick                       ,5554,3157,57,423,2397
31LTFE,Claremont                       ,5791,3485,54,515,2306
31LTFF,Clifton                         ,6163,3411,35,386,2752
31LTFG,Foxhall                         ,5317,3231,62,532,2086
31LTFH,Greenlands                      ,5552,2998,38,219,2554
31LTFJ,Hawes Side                      ,6125,3659,50,327,2466
31LTFK,Highfield                       ,6154,3453,34,194,2701
31LTFL,Ingthorpe                       ,5580,2952,29,248,2628
31LTFM,Layton                          ,5494,3202,45,242,2292
31LTFN,Marton                          ,5649,3530,28,180,2119
31LTFP,Norbreck                        ,5443,2721,23,151,2722
31LTFQ,Park                            ,5402,2627,61,510,2775
31LTFR,Squires Gate                    ,5118,2636,19,175,2482
31LTFS,Stanley                         ,4366,2632,19,178,1734
31LTFT,Talbot                          ,5041,3187,63,551,1854
31LTFU,Tyldesley                       ,5314,3067,44,318,2247
31LTFW,Victoria                        ,5385,2977,33,385,2408
31LTFX,Warbreck                        ,5781,3482,45,380,2299
31LTFY,Waterloo                        ,5228,3070,33,353,2158
31LTSS,Shipping                        ,0,0,0,0,0
31LUFA,Barclay                         ,3923,2129,32,322,1794
31LUFB,Briercliffe                     ,2540,1877,12,79,663
31LUFC,Brunshaw                        ,4151,2081,26,169,2070
31LUFD,Burnley Wood                    ,3190,1934,19,231,1256
31LUFE,Calder                          ,2805,1371,45,325,1434
31LUFF,Cliviger                        ,2017,1281,12,46,736
31LUFG,Coal Clough                     ,3144,1763,32,233,1381
31LUFH,Daneshouse                      ,3625,1966,39,428,1659
31LUFJ,Deerplay                        ,1274,857,8,40,417
31LUFK,Fulledge                        ,3285,1904,25,185,1381
31LUFL,Gawthorpe                       ,3743,2185,23,216,1558
31LUFM,Hapton                          ,2257,1536,16,144,721
31LUFN,Heasandford                     ,4155,2515,20,196,1640
31LUFP,Lanehead                        ,4889,3258,28,177,1631
31LUFQ,Lowerhouse                      ,3600,2015,10,135,1585
31LUFR,Park                            ,3560,2125,21,191,1435
31LUFS,Queensgate                      ,3722,2187,27,122,1535
31LUFT,Rosehill                        ,4075,2486,30,192,1589
31LUFU,Trinity                         ,2922,1771,29,269,1151
31LUFW,Whittlefield                    ,5211,3516,22,193,1695
31LUFX,Worsthorne                      ,2486,1683,7,52,803
31LUSS,Shipping                        ,0,0,0,0,0
31LWFA,Adlington                       ,4542,2969,28,200,1573
31LWFB,AndertonHeath Charnock and Rivi ,2554,1645,24,107,909
31LWFC,AnglezarkeHeapey and Wheelton   ,1204,833,5,31,371
31LWFD,Brindle and Hoghton             ,1500,977,10,31,523
31LWFE,Charnock Richard                ,1504,1017,13,40,487
31LWFF,Chorley East                    ,4148,2519,48,278,1629
31LWFG,Chorley North-East              ,4235,2673,39,262,1562
31LWFH,Chorley North-West              ,5359,3176,36,214,2183
31LWFJ,Chorley South-East              ,4259,2642,37,213,1617
31LWFK,Chorley South-West              ,4992,3038,48,272,1954
31LWFL,Chorley West                    ,4375,2626,43,205,1749
31LWFM,Clayton-le-Woods East           ,7522,5149,49,432,2373
31LWFN,Clayton-le-Woods West and Cuerde,3165,2167,20,111,998
31LWFP,Coppull North                   ,2917,1795,23,162,1122
31LWFQ,Coppull South                   ,3091,2053,19,140,1038
31LWFR,Eccleston and Heskin            ,4071,2671,21,102,1400
31LWFS,Euxton North                    ,2774,1779,23,96,995
31LWFT,Euxton South                    ,3329,2344,30,99,985
31LWFU,Lostock                         ,3437,2106,28,95,1331
31LWFW,Mawdesley                       ,1402,926,5,46,476
31LWFX,Whittle-Le-Woods                ,2866,1757,21,105,1109
31LWFY,Withnell                        ,2796,1896,25,103,900
31LWSS,Shipping                        ,0,0,0,0,0
31LXFA,Ansdell                         ,3271,1568,10,73,1703
31LXFB,Ashton                          ,3615,1765,17,118,1850
31LXFC,Bryning-with-Warton             ,2634,1574,18,74,1060
31LXFD,Central                         ,3607,1951,26,160,1656
31LXFE,Clifton                         ,3184,1392,7,57,1792
31LXFF,Elswick and Little Eccleston    ,1134,720,5,35,414
31LXFG,Fairhaven                       ,3449,1726,12,74,1723
31LXFH,Freckleton East                 ,2253,1361,12,63,892
31LXFJ,Freckleton West                 ,2443,1543,16,44,900
31LXFK,Heyhouses                       ,3847,1873,14,89,1974
31LXFL,Kilnhouse                       ,3827,1991,19,95,1836
31LXFM,Kirkham North                   ,2697,1717,16,66,980
31LXFN,Kirkham South                   ,2534,1443,22,56,1091
31LXFP,Medlar-with-Wesham              ,2158,1330,15,41,828
31LXFQ,Newton and Treales              ,2436,1661,13,58,775
31LXFR,Park                            ,3271,1418,15,61,1853
31LXFS,Ribby-with-Wrea                 ,1209,687,8,12,522
31LXFT,St.John's                       ,3409,1859,12,89,1550
31LXFU,St.Leonard's                    ,4032,2276,14,85,1756
31LXFW,Singleton and Greenhalgh        ,1155,706,5,35,449
31LXFX,Staining                        ,1488,1006,17,58,482
31LXFY,Weeton and Westby               ,1586,1031,9,50,555
31LXSS,Shipping                        ,0,0,0,0,0
31LYFA,Altham                          ,1158,733,9,64,425
31LYFB,Barnfield                       ,3129,1841,23,193,1288
31LYFC,Baxenden                        ,3965,2718,26,92,1247
31LYFD,Central                         ,3118,1633,34,283,1485
31LYFE,Church                          ,4686,2595,51,317,2091
31LYFF,Clayton-Le-Moors                ,4776,2920,33,193,1856
31LYFG,Eachill                         ,2642,1839,21,122,803
31LYFH,Huncoat                         ,3059,1972,32,160,1087
31LYFJ,Immanuel                        ,3914,2424,27,142,1490
31LYFK,Milnshaw                        ,4248,2259,25,163,1989
31LYFL,Netherton                       ,3785,2300,20,185,1485
31LYFM,Norden                          ,2630,1680,17,113,950
31LYFN,Overton                         ,4667,2897,36,157,1770
31LYFP,Peel                            ,3606,2187,30,161,1419
31LYFQ,St.Andrew's                     ,3324,1913,22,148,1411
31LYFR,St.Oswald's                     ,4533,3253,31,157,1280
31LYFS,Spring Hill                     ,3982,2269,46,338,1713
31LYSS,Shipping                        ,0,0,0,0,0
31LZFA,Alexandra                       ,4323,2539,53,559,1784
31LZFB,Arkholme                        ,1276,740,0,29,536
31LZFC,Bolton-le-Sands                 ,3379,1858,18,54,1521
31LZFD,Bulk                            ,5402,3006,50,324,2396
31LZFE,Carnforth                       ,4063,2530,30,112,1533
31LZFF,Castle                          ,5668,3393,56,364,2275
31LZFG,Caton                           ,2841,1605,24,62,1236
31LZFH,Ellel                           ,3221,2105,19,76,1116
31LZFJ,Halton-with-Aughton             ,1877,1103,7,35,774
31LZFK,Harbour                         ,4187,2212,27,208,1975
31LZFL,Heysham Central                 ,3063,1487,26,152,1576
31LZFM,Heysham North                   ,3217,1853,38,215,1364
31LZFN,Heysham South                   ,5648,3181,37,243,2467
31LZFP,Hornby                          ,1479,879,7,30,600
31LZFQ,John O'Gaunt                    ,4996,3191,35,221,1805
31LZFR,Kellet                          ,1564,963,6,44,601
31LZFS,Overton                         ,2131,1377,16,102,754
31LZFT,Parks                           ,3568,1464,20,105,2104
31LZFU,Poulton                         ,4514,2418,65,333,2096
31LZFW,Scotforth East                  ,3938,2218,29,124,1720
31LZFX,Scotforth West                  ,5078,2881,32,174,2197
31LZFY,Silverdale                      ,1730,789,9,33,941
31LZFZ,Skerton Central                 ,3207,1766,28,210,1441
31LZGA,Skerton East                    ,3012,1839,39,215,1173
31LZGB,Skerton West                    ,3872,2288,39,218,1584
31LZGC,Slyne-With-Hest                 ,2568,1270,3,52,1298
31LZGD,Torrisholme                     ,3625,1670,14,66,1955
31LZGE,Victoria                        ,4979,2738,40,206,2241
31LZGF,Warton                          ,1883,1091,12,57,792
31LZSS,Shipping                        ,0,0,0,0,0
31MAFA,Barrowford                      ,4749,2935,17,119,1814
31MAFB,Boulsworth                      ,4250,2682,22,109,1568
31MAFC,Bradley                         ,3861,1883,21,285,1978
31MAFD,Brierfield                      ,3632,2019,27,198,1613
31MAFE,Clover Hill                     ,3591,2306,24,150,1285
31MAFF,Coates                          ,3996,2408,32,139,1588
31MAFG,Craven                          ,4188,2588,19,120,1600
31MAFH,Earby                           ,4373,2758,23,138,1615
31MAFJ,Fence                           ,1932,1239,4,38,693
31MAFK,Foulridge                       ,1147,732,3,32,415
31MAFL,Horsfield                       ,3736,2102,30,184,1634
31MAFM,Marsden                         ,3889,2232,21,213,1657
31MAFN,Pendleside                      ,1173,824,8,23,349
31MAFP,Reedley                         ,3696,2329,24,108,1367
31MAFQ,Southfield                      ,3803,2200,24,219,1603
31MAFR,Vivary Bridge                   ,4333,2563,33,276,1770
31MAFS,Walverden                       ,3184,1755,17,177,1429
31MAFT,Waterside                       ,3245,1821,37,246,1424
31MAFU,Whitefield                      ,3193,1608,36,313,1585
31MASS,Shipping                        ,0,0,0,0,0
31MBFA,Ashton                          ,5009,3052,27,184,1957
31MBFB,Avenham                         ,5381,2957,63,690,2424
31MBFC,Brookfield                      ,4941,2693,35,379,2248
31MBFD,Cadley                          ,5115,3088,23,115,2027
31MBFE,Central                         ,5281,2819,48,656,2462
31MBFF,Deepdale                        ,5269,2863,44,494,2406
31MBFG,Fishwick                        ,4721,2732,44,488,1989
31MBFH,Greyfriars                      ,5147,3459,17,131,1688
31MBFJ,Ingol                           ,5502,3285,46,382,2217
31MBFK,Larches                         ,4709,2775,28,243,1934
31MBFL,Moor Park                       ,5500,3342,56,348,2158
31MBFM,Preston Rural East              ,5502,3306,29,79,2196
31MBFN,Preston Rural West              ,5750,3507,25,139,2243
31MBFP,Ribbleton                       ,4735,2732,33,533,2003
31MBFQ,Riversway                       ,4646,2892,32,420,1754
31MBFR,St. Matthew's                   ,5608,3125,41,486,2483
31MBFS,Sharoe Green                    ,5345,3529,35,133,1816
31MBFT,Sherwood                        ,5262,3397,34,141,1865
31MBFU,Tulketh                         ,5376,3565,39,256,1811
31MBSS,Shipping                        ,0,0,0,0,0
31MCFA,AightonBailey and Chaigley      ,0,0,0,0,0
31MCFB,Alston                          ,2754,1945,13,55,809
31MCFC,Billington                      ,3584,2157,11,71,1427
31MCFD,Bolton-by-Bowland               ,0,0,0,0,0
31MCFE,BowlandNewton and Slaidburn     ,1470,967,6,25,503
31MCFF,Chatburn                        ,986,586,5,33,400
31MCFG,Chipping                        ,1119,768,7,23,351
31MCFH,Clayton-le-Dale and Salesbury   ,1297,766,4,26,531
31MCFJ,Dilworth                        ,3092,1996,9,76,1096
31MCFK,EdisfordLow Moor and Trinity    ,3700,2349,20,137,1351
31MCFL,GisburnRimington                ,1531,1010,4,26,521
31MCFM,Grammar School                  ,3125,1817,11,78,1308
31MCFN,Grindleton and West Bradford    ,1198,731,6,30,467
31MCFP,Mellor                          ,2967,1808,17,72,1159
31MCFQ,Read                            ,1186,744,8,17,442
31MCFR,Ribblesdale                     ,2042,1176,7,64,866
31MCFS,Ribchester                      ,1339,871,7,24,468
31MCFT,Sabden                          ,1033,635,9,22,398
31MCFU,St.James's                      ,1914,1188,11,58,726
31MCFW,Simonstone                      ,1030,667,6,19,363
31MCFX,Waddington                      ,985,600,5,13,385
31MCFY,Whalley                         ,2850,1073,4,42,1777
31MCFZ,Wilpshire                       ,2142,1334,12,40,808
31MCGA,Wiswell and Pendleton           ,871,525,7,17,346
31MCSS,SHIPPING                        ,0,0,0,0,0
31MDFA,Cribden                         ,5316,3453,18,173,1863
31MDFB,Eden                            ,2864,1905,12,114,959
31MDFC,Facit and Shawforth             ,2377,1546,16,129,831
31MDFD,Greenfield                      ,4353,2759,29,207,1594
31MDFE,Greensclough                    ,3775,2416,25,240,1359
31MDFF,Hareholme                       ,4420,2546,26,149,1874
31MDFG,Healey and Whitworth            ,3612,2378,20,218,1234
31MDFH,Helmshore                       ,5373,3697,44,163,1676
31MDFJ,Irwell                          ,4227,2694,26,212,1533
31MDFK,Longholme                       ,4103,2453,28,183,1650
31MDFL,Stacksteads                     ,3413,2043,19,196,1370
31MDFM,Whitewell                       ,4459,2834,40,193,1625
31MDFN,Worsley                         ,3256,1956,28,169,1300
31MDSS,Shipping                        ,0,0,0,0,0
31MEFA,All Saints                      ,4282,2902,29,109,1380
31MEFB,Bamber Bridge Central           ,4795,3064,40,170,1731
31MEFC,Bamber Bridge South             ,4314,2870,31,179,1444
31MEFD,Charnock                        ,1485,1008,2,62,477
31MEFE,Farington                       ,5059,3526,45,176,1533
31MEFF,Howick                          ,2773,1745,16,52,1028
31MEFG,Hutton and New Longton          ,4117,2478,14,74,1639
31MEFH,Kingsfold                       ,5011,3227,34,213,1784
31MEFJ,Leyland Central                 ,2964,1930,32,129,1034
31MEFK,Leyland St.Ambrose              ,3130,2099,26,113,1031
31MEFL,Leyland St.John's               ,4413,2732,42,253,1681
31MEFM,Leyland St.Mary's               ,4620,2920,28,132,1700
31MEFN,Little Hoole and Much Hoole     ,3018,1984,21,68,1034
31MEFP,Longton Central and West        ,3746,2336,17,85,1410
31MEFQ,Lostock Hall                    ,5263,3771,31,188,1492
31MEFR,Manor                           ,3410,2176,17,74,1234
31MEFS,Middleforth Green               ,3213,2068,25,147,1145
31MEFT,Moss Side                       ,4482,3122,50,222,1360
31MEFU,Priory                          ,2197,1369,7,55,828
31MEFW,Samlesbury and Cuerdale         ,993,598,6,11,395
31MEFX,Seven Stars                     ,3152,1809,36,207,1343
31MEFY,Walton-le-Dale                  ,4063,2748,17,124,1315
31MESS,Shipping                        ,0,0,0,0,0
31MFFA,Aughton Park                    ,2925,1713,18,94,1212
31MFFB,Aughton Town Green              ,4058,2389,29,140,1669
31MFFC,Bickerstaffe                    ,971,601,2,26,370
31MFFD,Birch Green                     ,7649,4750,114,790,2899
31MFFE,Burscough                       ,3887,2534,28,162,1353
31MFFF,Derby                           ,5589,3314,33,156,2275
31MFFG,Digmoor                         ,3269,1973,72,349,1296
31MFFH,Downholland                     ,1047,681,18,42,366
31MFFJ,Halsall                         ,1630,971,15,48,659
31MFFK,Hesketh-with-Becconsall         ,2735,1802,18,83,933
31MFFL,Knowsley                        ,4331,2616,29,115,1715
31MFFM,Lathom                          ,2811,1668,20,98,1143
31MFFN,Moorside                        ,3312,2039,64,417,1273
31MFFP,Newburgh                        ,1730,1104,10,43,626
31MFFQ,North Meols                     ,2879,1664,23,89,1215
31MFFR,Parbold                         ,3290,2090,15,87,1200
31MFFS,Rufford                         ,1447,919,13,32,528
31MFFT,Scarisbrick                     ,2520,1552,18,74,968
31MFFU,Scott                           ,4381,2617,28,188,1764
31MFFW,Skelmersdale North              ,4566,2917,53,357,1649
31MFFX,Skelmersdale South              ,4248,2509,57,309,1739
31MFFY,Tanhouse                        ,3838,2299,68,514,1539
31MFFZ,Tarleton                        ,3894,2497,22,123,1397
31MFGA,Upholland North                 ,2905,1793,32,151,1112
31MFGB,Upholland South                 ,2580,1465,22,106,1115
31MFGC,Wrightington                    ,2453,1551,15,96,902
31MFSS,Shipping                        ,0,0,0,0,0
31MGFA,Bailey                          ,3865,2253,34,193,1612
31MGFB,Bourne                          ,5503,3428,42,247,2075
31MGFC,Breck                           ,2858,1519,24,71,1339
31MGFD,Brock                           ,1192,733,3,17,459
31MGFE,Calder                          ,1225,766,8,19,459
31MGFF,Carleton                        ,3964,2505,30,81,1459
31MGFG,Catterall                       ,1612,1047,12,25,565
31MGFH,Cleveleys Park                  ,3965,1711,33,132,2254
31MGFJ,Duchy                           ,1590,811,2,24,779
31MGFK,Garstang                        ,3293,1797,8,63,1496
31MGFL,Great Eccleston                 ,2365,1508,13,57,857
31MGFM,Hambleton                       ,3854,2178,15,80,1676
31MGFN,Hardhorn                        ,2651,1378,10,51,1273
31MGFP,High Cross                      ,2743,1614,17,58,1129
31MGFQ,Jubilee                         ,3411,1578,28,119,1833
31MGFR,Mount                           ,3073,1844,24,192,1229
31MGFS,Norcross                        ,3117,1688,18,106,1429
31MGFT,Park                            ,3853,2305,33,255,1548
31MGFU,Pharos                          ,3041,1582,30,262,1459
31MGFW,Pilling                         ,1736,1121,10,21,615
31MGFX,Preesall                        ,4424,1972,20,113,2452
31MGFY,Rossall                         ,3993,2165,28,198,1828
31MGFZ,Staina                          ,4247,2276,17,113,1971
31MGGA,Tithebarn                       ,3038,1713,12,72,1325
31MGGB,Victoria                        ,3899,1935,12,96,1964
31MGGC,Warren                          ,3824,2238,27,193,1586
31MGGD,Wyresdale                       ,1485,934,4,29,551
31MGSS,Shipping                        ,0,0,0,0,0
32MHFA,Cosby                           ,2701,1945,9,74,756
32MHFB,Countesthorpe                   ,5113,3636,20,138,1477
32MHFC,Croft Hill                      ,1335,885,4,47,450
32MHFD,Ellis                           ,2999,1968,12,89,1031
32MHFE,Enderby                         ,3221,2267,11,99,954
32MHFF,Fairestone                      ,4694,3185,23,134,1509
32MHFG,Flamville                       ,3171,2115,21,116,1056
32MHFH,Fosse                           ,1532,1040,14,80,492
32MHFJ,Glen Parva                      ,4194,2905,24,136,1289
32MHFK,Kirby                           ,3771,2322,12,87,1449
32MHFL,Leicester Forest East           ,3891,2789,12,103,1102
32MHFM,Millfield                       ,1643,1081,8,38,562
32MHFN,Narborough                      ,6014,4304,26,138,1710
32MHFP,Normanton                       ,1997,1460,9,51,537
32MHFQ,Northfield                      ,2443,1538,11,88,905
32MHFR,Ravenhurst                      ,4659,3151,37,169,1508
32MHFS,St.Johns                        ,1503,899,10,43,604
32MHFT,Stanton                         ,2805,2022,11,98,783
32MHFU,Whetstone                       ,3178,2322,14,112,856
32MHFW,Winchester                      ,2820,1965,14,102,855
32MHFX,Winstanley                      ,2491,1660,14,113,831
32MHSS,Shipping                        ,0,0,0,0,0
32MJFA,Ashby                           ,2567,1615,29,139,952
32MJFB,Barrow Upon Soar and Quorndon   ,7530,4884,38,177,2646
32MJFC,Birstall Goscote                ,1882,1181,1,55,701
32MJFD,Birstall Greengate              ,2210,1469,17,60,741
32MJFE,Birstall Netherhall             ,1537,957,6,31,580
32MJFF,Birstall Riverside              ,1831,1258,14,58,573
32MJFG,Birstall Stonehill              ,2210,1452,14,84,758
32MJFH,Bradgate                        ,5873,3902,35,183,1971
32MJFJ,East Goscote                    ,2307,1798,15,84,509
32MJFK,Garendon                        ,4791,3384,29,147,1407
32MJFL,Hastings                        ,4255,2503,25,272,1752
32MJFM,Hathern                         ,5717,4027,33,202,1690
32MJFN,Lemyngton                       ,4037,2646,29,264,1391
32MJFP,Mountsorrel and Rothley         ,7340,4797,41,253,2543
32MJFQ,Nanpantan                       ,3489,2262,12,85,1227
32MJFR,Outwoods                        ,3514,2190,11,75,1324
32MJFS,Queniborough                    ,2521,1619,7,61,902
32MJFT,Shepshed East                   ,5139,3697,34,161,1442
32MJFU,Shepshed West                   ,5073,3420,28,165,1653
32MJFW,Sileby                          ,5281,3659,28,203,1622
32MJFX,Six Hills                       ,1993,1256,10,50,737
32MJFY,Southfields                     ,3135,1771,16,99,1364
32MJFZ,Storer                          ,3434,1940,24,152,1494
32MJGA,Syston                          ,8723,5980,34,285,2743
32MJGB,The Wolds                       ,2121,1374,9,33,747
32MJGC,Thurcaston                      ,1649,1019,8,33,630
32MJGD,Thurmaston                      ,7350,5046,37,295,2304
32MJGE,Woodhouse and Swithland         ,2045,1219,10,56,826
32MJGF,Woodthorpe                      ,3619,2108,33,254,1511
32MJSS,Shipping                        ,0,0,0,0,0
32MKFA,Billesdon                       ,1081,665,4,24,416
32MKFB,Bosworth                        ,1372,884,7,32,488
32MKFC,Broughton                       ,4749,3572,21,126,1177
32MKFD,Dunton                          ,1426,982,10,37,444
32MKFE,Easton                          ,1501,968,3,37,533
32MKFF,Fleckney                        ,3270,2429,18,118,841
32MKFG,Gilmorton                       ,1459,1039,5,37,420
32MKFH,Glen                            ,2982,1961,8,78,1021
32MKFJ,Houghton                        ,1642,1107,6,48,535
32MKFK,Kibworth                        ,3790,2376,10,95,1414
32MKFL,Kilworth                        ,1581,950,4,47,631
32MKFM,Langton                         ,851,534,3,22,317
32MKFN,Lubenham                        ,1359,873,11,34,486
32MKFP,Lutterworth Linden              ,1683,1147,10,33,536
32MKFQ,Lutterworth St.Mary's           ,1209,719,5,35,490
32MKFR,Lutterworth Sherrier            ,1609,1017,7,54,592
32MKFS,Lutterworth Wycliffe            ,1300,806,5,34,494
32MKFT,Market Harborough Bowden        ,2994,2066,24,94,928
32MKFU,Market Harborough North         ,3634,2329,25,120,1305
32MKFW,Market Harborough South         ,2697,1696,13,92,1001
32MKFX,Market Harborough West          ,4056,2534,34,138,1522
32MKFY,Peatling                        ,1485,1052,4,42,433
32MKFZ,Scraptoft                       ,961,626,3,21,335
32MKGA,Thurnby                         ,2525,1613,14,78,912
32MKGB,Tilton                          ,1051,723,13,33,328
32MKGC,Ullesthorpe                     ,1561,1067,8,52,494
32MKSS,Shipping                        ,0,0,0,0,0
32MLFA,Ambien                          ,2322,1547,12,78,775
32MLFB,Bagworth                        ,1327,782,3,56,545
32MLFC,BarlestoneNailstone and Osbasto ,2391,1638,19,80,753
32MLFD,Barwell                         ,6599,4521,51,290,2078
32MLFE,Burbage                         ,8336,5754,28,243,2582
32MLFF,CadebyCarlton and Market Boswor ,1943,1117,2,22,826
32MLFG,Castle                          ,5693,3418,31,226,2275
32MLFH,Clarendon                       ,7095,5007,42,284,2088
32MLFJ,De Montfort                     ,7266,4866,30,224,2400
32MLFK,Desford and Peckleton           ,3590,2396,11,101,1194
32MLFL,Earl Shilton                    ,7146,4661,30,289,2485
32MLFM,Groby                           ,5864,4205,29,158,1659
32MLFN,Markfield                       ,3905,2436,22,113,1469
32MLFP,Newbold Verdon                  ,2740,1784,21,79,956
32MLFQ,Ratby                           ,2852,1925,10,99,927
32MLFR,Sheepy and Witherley            ,2184,1413,11,48,771
32MLFS,Trinity                         ,4440,3047,31,237,1393
32MLFT,Twycross and Shackerstone       ,1164,750,5,26,414
32MLSS,Shipping                        ,0,0,0,0,0
32MMFA,Abbey                           ,6629,4251,48,471,2378
32MMFB,Aylestone                       ,7960,5154,48,414,2806
32MMFC,Beaumont Leys                   ,11090,7472,121,1084,3618
32MMFD,Belgrave                        ,7962,4744,72,724,3218
32MMFE,Castle                          ,7385,4713,60,593,2672
32MMFF,Charnwood                       ,6840,4043,67,702,2797
32MMFG,Coleman                         ,6904,3956,57,588,2948
32MMFH,Crown Hills                     ,7015,4302,68,598,2713
32MMFJ,East Knighton                   ,6468,3781,11,205,2687
32MMFK,Evington                        ,7149,3946,32,245,3203
32MMFL,Eyres Monsell                   ,7070,3986,40,562,3084
32MMFM,Humberstone                     ,6918,4054,29,390,2864
32MMFN,Latimer                         ,6063,3562,75,574,2501
32MMFP,Mowmacre                        ,5512,2840,43,493,2672
32MMFQ,New Parks                       ,7928,4372,59,614,3556
32MMFR,North Braunstone                ,6123,3197,73,823,2926
32MMFS,Rowley Fields                   ,7543,4567,52,497,2976
32MMFT,Rushey Mead                     ,8783,5627,57,622,3156
32MMFU,Saffron                         ,8136,4692,66,750,3444
32MMFW,St.Augustine's                  ,7579,4893,48,519,2686
32MMFX,Spinney Hill                    ,6717,3817,101,908,2900
32MMFY,Stoneygate                      ,7337,4418,56,545,2919
32MMFZ,Thurncourt                      ,7903,4488,54,402,3415
32MMGA,Westcotes                       ,7484,4690,47,576,2794
32MMGB,Western Park                    ,8671,5154,47,529,3517
32MMGC,West Humberstone                ,7463,4471,51,598,2992
32MMGD,West Knighton                   ,6880,4346,39,319,2534
32MMGE,Wycliffe                        ,8498,4767,144,1566,3731
32MMSS,Shipping                        ,0,0,0,0,0
32MNFA,Asfordby                        ,2482,1649,20,64,833
32MNFB,Bottesford                      ,2398,1529,15,67,869
32MNFC,Craven                          ,2682,1864,22,89,818
32MNFD,Croxton Kerrial                 ,1086,643,15,21,443
32MNFE,Egerton                         ,2417,1433,21,134,984
32MNFF,Frisby-On-The-Wreake            ,1371,908,1,29,463
32MNFG,Gaddesby                        ,1047,670,5,35,377
32MNFH,Long Clawson                    ,1715,1046,4,41,669
32MNFJ,Mowbray                         ,3317,2388,26,103,929
32MNFK,Newport                         ,4725,2898,40,124,1827
32MNFL,Old Dalby                       ,1538,972,9,30,566
32MNFM,Somerby                         ,1592,1006,15,27,586
32MNFN,Stathern                        ,1047,663,5,21,384
32MNFP,Sysonby                         ,3350,2212,18,97,1138
32MNFQ,Waltham-On-The-Wolds            ,1382,854,7,30,528
32MNFR,Warwick                         ,2739,1629,14,85,1110
32MNFS,Wymondham                       ,1214,804,9,33,410
32MNSS,Shipping                        ,0,0,0,0,0
32MPFA,Appleby                         ,1590,918,5,51,672
32MPFB,Breedon                         ,1497,957,5,35,540
32MPFC,Castle                          ,1797,1164,12,44,633
32MPFD,Castle Donington                ,5007,3490,28,207,1517
32MPFE,Coalville                       ,3148,1870,25,153,1278
32MPFF,Greenhill                       ,4568,2668,54,304,1900
32MPFG,Holly Hayes                     ,2927,1642,17,85,1285
32MPFH,Holywell                        ,3245,2114,10,133,1131
32MPFJ,Hugglescote                     ,3390,2001,23,135,1389
32MPFK,Ibstock and Heather             ,5257,3235,35,237,2022
32MPFL,Ivanhoe                         ,3334,1929,13,137,1405
32MPFM,Kegworth                        ,3144,2096,13,105,1048
32MPFN,Long Whatton                    ,1306,854,3,30,452
32MPFP,Measham                         ,3213,2016,32,197,1197
32MPFQ,Moira                           ,3363,1918,25,123,1445
32MPFR,Oakthorpe and Donisthorpe       ,1633,914,9,80,719
32MPFS,Ravenstone                      ,2110,1256,18,70,854
32MPFT,Snibston                        ,3003,1884,28,137,1119
32MPFU,Swannington                     ,1665,1042,20,49,623
32MPFW,Thringstone                     ,3134,1992,21,101,1142
32MPFX,Whitwick                        ,4666,2925,32,184,1741
32MPFY,Worthington                     ,1444,922,11,44,522
32MPSS,Shipping                        ,0,0,0,0,0
32MQFA,All Saints                      ,6473,4813,35,188,1660
32MQFB,Bassett                         ,2819,1983,13,127,836
32MQFC,Brocks Hill                     ,4197,2707,16,107,1490
32MQFD,Brookside                       ,6181,4192,25,194,1989
32MQFE,Central                         ,4060,2448,17,178,1612
32MQFF,Fairfield                       ,3053,2123,19,138,930
32MQFG,Grange                          ,2465,1459,11,57,1006
32MQFH,St.Peter's                      ,2937,1643,11,90,1294
32MQFJ,St.Wolstan's                    ,5994,4316,24,195,1678
32MQFK,Westfield                       ,3234,2157,31,117,1077
32MQSS,Shipping                        ,0,0,0,0,0
32MRFA,Barrowden                       ,1041,635,1,21,406
32MRFB,Belton                          ,1160,683,3,26,477
32MRFC,Braunston                       ,0,0,0,0,0
32MRFD,Casterton                       ,0,0,0,0,0
32MRFE,Cottesmore                      ,1976,1511,37,43,465
32MRFF,Edith Weston                    ,1346,1000,3,35,346
32MRFG,Empingham                       ,1733,990,13,39,743
32MRFH,Exton                           ,1961,1294,33,74,667
32MRFJ,Ketton                          ,1512,827,8,43,685
32MRFK,Langham                         ,1038,586,0,26,452
32MRFL,Luffenham                       ,1145,725,4,38,420
32MRFM,Oakham East                     ,2801,1790,9,70,1011
32MRFN,Oakham West                     ,4126,2768,29,162,1358
32MRFP,Ryhall                          ,1476,940,3,51,536
32MRFQ,Uppingham                       ,2502,1583,10,68,919
32MRFR,Whissendine                     ,1402,903,5,45,499
32MRSS,Shipping                        ,0,0,0,0,0
33MSFA,Bargate                         ,1991,1219,16,128,772
33MSFB,Central                         ,2355,1442,24,153,913
33MSFC,Coastal                         ,2696,1618,21,89,1078
33MSFD,Fenside                         ,3659,2115,43,344,1544
33MSFE,Fishtoft                        ,4321,2673,46,136,1648
33MSFF,Five Village                    ,2694,1569,24,128,1125
33MSFG,Frampton                        ,1110,666,9,37,444
33MSFH,Holland Fen                     ,0,0,0,0,0
33MSFJ,Kirton                          ,3032,1776,25,116,1256
33MSFK,Old Leake                       ,1286,773,15,59,513
33MSFL,Skirbeck                        ,3402,1963,32,199,1439
33MSFM,South                           ,1992,1201,19,85,791
33MSFN,Swineshead                      ,2391,1433,24,101,958
33MSFP,West                            ,3994,2454,31,146,1540
33MSFQ,Witham                          ,4199,2443,28,187,1756
33MSFR,Wrangle                         ,1041,622,12,27,419
33MSFS,Wyberton                        ,3147,1931,44,110,1216
33MSSS,Shipping                        ,0,0,0,0,0
33MTFA,Alford                          ,2881,1512,19,127,1369
33MTFB,Binbrook                        ,1307,718,11,54,589
33MTFC,Burgh le Marsh                  ,2301,1176,12,101,1125
33MTFD,Chapel St Leonards              ,2481,1016,21,152,1465
33MTFE,Coningsby                       ,2418,1745,19,101,673
33MTFF,Donington on Bain               ,1600,954,12,69,646
33MTFG,Fotherby                        ,1028,610,9,38,418
33MTFH,Friskney                        ,1137,656,10,52,481
33MTFJ,Frithville                      ,1591,984,12,52,607
33MTFK,Grimoldby                       ,1658,988,17,73,670
33MTFL,Halton Holgate                  ,1367,738,18,68,629
33MTFM,Hogsthorpe                      ,1748,867,14,117,881
33MTFN,Holton le Clay                  ,2967,2002,32,109,965
33MTFP,Horncastle                      ,4428,2393,24,154,2035
33MTFQ,Hundleby                        ,1583,821,13,46,762
33MTFR,Ingoldmells                     ,1751,843,18,157,908
33MTFS,Legbourne                       ,1195,735,7,49,460
33MTFT,Mablethorpe                     ,5409,2201,55,427,3208
33MTFU,Mareham le Fen                  ,1400,780,6,62,620
33MTFW,Marsh Chapel                    ,1714,1012,7,75,702
33MTFX,New Leake                       ,1422,833,16,84,589
33MTFY,North Holme                     ,1737,1050,12,67,687
33MTFZ,North Somercotes                ,1846,994,5,103,852
33MTGA,North Thoresby                  ,1631,962,14,64,669
33MTGB,Partney                         ,1041,572,8,37,469
33MTGC,Priory                          ,1496,895,14,72,601
33MTGD,Roughton                        ,1317,803,7,86,514
33MTGE,St Clements                     ,3657,1848,28,272,1809
33MTGF,St James'                       ,1587,918,7,77,669
33MTGG,St Margaret's                   ,1870,1102,23,90,768
33MTGH,St Mary's                       ,1638,911,8,55,727
33MTGJ,St Michael's                    ,1649,1026,14,59,623
33MTGK,Scarbrough                      ,3031,1682,32,327,1349
33MTGL,Seacroft                        ,3743,1817,28,211,1926
33MTGM,Sibsey                          ,1927,1079,16,63,848
33MTGN,Spilsby                         ,1598,855,14,44,743
33MTGP,Sutton and Trusthorpe           ,3501,1117,13,180,2384
33MTGQ,Tattershall                     ,1792,1206,13,55,586
33MTGR,Tetford                         ,1396,828,8,48,568
33MTGS,Tetney                          ,1694,1059,18,66,635
33MTGT,Theddlethorpe St Helen          ,1259,662,15,56,597
33MTGU,Trinity                         ,1426,803,21,72,623
33MTGW,Wainfleet                       ,1810,970,22,89,840
33MTGX,Willoughby with Sloothby        ,1201,686,9,62,515
33MTGY,Winthorpe                       ,3317,1837,19,286,1480
33MTGZ,Withern with Stain              ,1437,791,13,97,646
33MTHA,Woodhall Spa                    ,2746,1319,8,82,1427
33MTHB,Wragby                          ,1741,1011,14,54,730
33MTSS,Shipping                        ,0,0,0,0,0
33MUFA,Abbey                           ,5220,3234,78,517,1986
33MUFB,Birchwood                       ,9817,6368,104,692,3449
33MUFC,Boultham                        ,5368,3353,61,358,2015
33MUFD,Bracebridge                     ,5958,3836,63,310,2122
33MUFE,Carholme                        ,5729,3661,64,433,2068
33MUFF,Castle                          ,5545,3035,50,368,2510
33MUFG,Longdales                       ,4842,2474,36,301,2368
33MUFH,Minster                         ,7734,4583,97,731,3151
33MUFJ,Moorland                        ,5149,2903,46,380,2246
33MUFK,Park                            ,5300,3439,62,507,1861
33MUFL,Tritton                         ,4243,2169,42,276,2074
33MUSS,Shipping                        ,0,0,0,0,0
33MWFA,Ashby de la Launde              ,1721,1125,17,52,596
33MWFB,Bassingham                      ,1813,1095,14,54,718
33MWFC,Billinghay                      ,1729,927,16,52,802
33MWFD,Bracebridge Heath               ,2716,1447,15,84,1269
33MWFE,Branston and Mere               ,3407,2027,33,129,1380
33MWFF,Brant Broughton and Stragglethor,1969,1345,14,50,624
33MWFG,Cranwell and Byard's Leap       ,1988,1546,26,51,442
33MWFH,Eagle and North Scarle          ,1515,897,13,53,618
33MWFJ,Heckington                      ,1801,1015,12,59,786
33MWFK,Heighington                     ,1779,1043,12,50,736
33MWFL,Helpringham                     ,1440,818,7,60,622
33MWFM,Leasingham                      ,2168,1226,15,48,942
33MWFN,Martin                          ,1306,718,16,39,588
33MWFP,Metheringham                    ,3219,1763,29,130,1456
33MWFQ,Navenby                         ,1467,868,13,44,599
33MWFR,North Hykeham Central           ,2759,1702,22,87,1057
33MWFS,North Hykeham North             ,3146,1964,27,92,1182
33MWFT,North Hykeham South             ,2789,1539,28,115,1250
33MWFU,North Kyme                      ,1490,932,5,55,558
33MWFW,Osbournby                       ,1186,707,10,44,479
33MWFX,Ruskington                      ,3481,2006,18,111,1475
33MWFY,Skellingthorpe                  ,2831,1703,18,88,1128
33MWFZ,Sleaford East                   ,1644,946,8,58,698
33MWGA,Sleaford North                  ,2247,1481,25,99,766
33MWGB,Sleaford South                  ,2794,1748,29,57,1046
33MWGC,Sleaford West                   ,1813,1086,20,81,727
33MWGD,Waddington East                 ,2731,1811,21,97,920
33MWGE,Waddington West                 ,1796,1213,14,78,583
33MWGF,Washingborough                  ,3031,1887,29,88,1144
33MWGG,Wellingore                      ,1516,844,17,37,672
33MWSS,Shipping                        ,0,0,0,0,0
33MXFA,Crowland                        ,2692,1688,16,78,1004
33MXFB,Deeping St. Nicholas            ,1011,658,19,48,353
33MXFC,Donington                       ,2936,1740,22,103,1196
33MXFD,Fleet                           ,1445,774,3,45,671
33MXFE,Gedney                          ,1571,934,8,68,637
33MXFF,Gosberton Village               ,1468,810,8,31,658
33MXFG,Holbeach Hurn                   ,1565,1020,9,71,545
33MXFH,Holbeach St.Johns               ,1371,833,10,47,538
33MXFJ,Holbeach Town                   ,4526,2437,28,143,2089
33MXFK,Long Sutton                     ,4187,2226,19,118,1961
33MXFL,Moulton                         ,2491,1487,15,71,1004
33MXFM,Pinchbeck East                  ,3002,1822,15,86,1180
33MXFN,Pinchbeck West                  ,1031,691,6,36,340
33MXFP,Spalding Central                ,1239,808,7,48,431
33MXFQ,Spalding East                   ,4104,2376,31,156,1728
33MXFR,Spalding North                  ,1404,890,6,61,514
33MXFS,Spalding South                  ,3954,2399,22,124,1555
33MXFT,Spalding West                   ,5505,3236,33,140,2269
33MXFU,Surfleet                        ,1646,978,15,60,668
33MXFW,Sutton Bridge                   ,3463,2128,30,153,1335
33MXFX,The Saints                      ,1573,906,7,68,667
33MXFY,Weston                          ,1823,1105,8,48,718
33MXFZ,Whaplode                        ,1555,932,12,57,623
33MXSS,Shipping                        ,0,0,0,0,0
33MYFA,All Saints                      ,2884,1956,20,147,928
33MYFB,Aveland                         ,1626,866,8,67,760
33MYFC,Barrowby                        ,1660,1033,10,55,627
33MYFD,Belmont                         ,2783,2100,26,99,683
33MYFE,Bourne East                     ,4100,2490,25,161,1610
33MYFF,Bourne West                     ,3893,2426,17,117,1467
33MYFG,Casewick                        ,1324,810,2,40,514
33MYFH,Deeping St.James                ,4754,3333,25,143,1421
33MYFJ,Devon                           ,1503,938,13,43,565
33MYFK,Earlesfield                     ,3988,2430,64,374,1558
33MYFL,Ermine                          ,1281,743,7,34,538
33MYFM,Forest                          ,1049,660,8,35,389
33MYFN,Glen Eden                       ,1268,799,6,36,469
33MYFP,Grantham St.Johns               ,3501,2334,36,169,1167
33MYFQ,Greyfriars                      ,5720,3935,45,175,1785
33MYFR,Harrowby                        ,4202,2324,45,212,1878
33MYFS,Heath                           ,1296,746,3,43,550
33MYFT,Hillsides                       ,1614,1013,3,54,601
33MYFU,Isaac Newton                    ,1480,900,7,40,580
33MYFW,Lincrest                        ,1392,842,14,46,550
33MYFX,Loveden                         ,1220,768,9,36,452
33MYFY,Market and West Deeping         ,4242,2859,32,165,1383
33MYFZ,Morkery                         ,1954,1279,11,93,675
33MYGA,Peascliffe                      ,1541,864,7,40,677
33MYGB,Ringstone                       ,1635,988,6,62,647
33MYGC,St.Annes                        ,4157,2518,25,217,1639
33MYGD,St.Georges                      ,3252,1955,17,118,1297
33MYGE,St.Marys                        ,4051,2186,14,158,1865
33MYGF,St.Wulframs                     ,3682,2185,24,103,1497
33MYGG,Saxonwell                       ,1810,1021,6,63,789
33MYGH,Stamford St.Johns               ,3985,2810,11,112,1175
33MYGJ,Toller                          ,1079,596,5,22,483
33MYGK,Truesdale                       ,1412,931,5,45,481
33MYGL,Witham Valley                   ,1292,764,6,36,528
33MYSS,Shipping                        ,0,0,0,0,0
33MZFA,Ancholme Valley                 ,1457,852,15,42,605
33MZFB,Bardney                         ,1737,1008,13,68,729
33MZFC,Caistor                         ,2010,1251,16,80,759
33MZFD,Dunholme                        ,1812,1058,14,70,754
33MZFE,Forest                          ,1833,1103,21,71,730
33MZFF,Gainsborough East               ,5086,2853,99,480,2233
33MZFG,Gainsborough North              ,4585,2646,59,297,1939
33MZFH,Gainsborough South-West         ,4193,2560,52,328,1633
33MZFJ,Hemswell                        ,1487,957,11,64,530
33MZFK,Kelsey                          ,1789,1087,14,55,702
33MZFL,Lea                             ,1653,957,11,45,696
33MZFM,Market Rasen                    ,3461,1979,31,120,1482
33MZFN,Middle Rasen                    ,1781,1017,8,55,764
33MZFP,Nettleham                       ,3121,1709,21,76,1412
33MZFQ,Saxilby                         ,2961,1788,16,101,1173
33MZFR,Scampton                        ,1687,1213,24,55,474
33MZFS,Scotter                         ,2131,1342,14,71,789
33MZFT,South Cliff                     ,1224,725,21,51,499
33MZFU,Stow                            ,1581,908,14,49,673
33MZFW,Thonock                         ,1624,962,27,63,662
33MZFX,Torksey                         ,1758,873,3,63,885
33MZFY,Walshcroft                      ,1028,585,6,45,443
33MZFZ,Welton                          ,2265,1296,18,60,969
33MZGA,Witham                          ,5251,3112,60,178,2139
33MZGB,Wold View                       ,1348,822,10,56,526
33MZGC,Yarborough                      ,2280,1467,28,76,813
33MZSS,Shipping                        ,0,0,0,0,0
34NAFA,All Saints                      ,1580,966,6,55,614
34NAFB,Beetley and Gressenhall         ,1773,980,13,53,793
34NAFC,Besthorpe                       ,1954,1210,11,54,744
34NAFD,Buckenham                       ,1322,797,5,38,525
34NAFE,Conifer                         ,1943,1178,20,61,765
34NAFF,East Dereham-Neatherd           ,2947,1601,17,93,1346
34NAFG,East Dereham-St.Withburga       ,1849,1010,14,92,839
34NAFH,East Dereham-Toftwood           ,3962,2447,33,159,1515
34NAFJ,East Dereham-Town               ,2353,1285,20,113,1068
34NAFK,East Guiltcross                 ,1360,899,5,60,461
34NAFL,Eynsford                        ,1349,810,8,48,539
34NAFM,Haggard de Toni                 ,1679,925,5,61,754
34NAFN,Harling                         ,1665,1038,9,49,627
34NAFP,Haverscroft                     ,1660,826,6,44,834
34NAFQ,Heathlands                      ,1438,914,4,50,524
34NAFR,Hermitage                       ,1178,654,9,65,524
34NAFS,Launditch                       ,1368,714,6,64,654
34NAFT,Mattishall                      ,1978,1171,9,56,807
34NAFU,Mid-Forest                      ,1028,626,3,48,402
34NAFW,Nar Valley                      ,1767,1014,12,72,753
34NAFX,Necton                          ,1504,718,11,48,786
34NAFY,Peddars Way                     ,1596,1067,4,56,529
34NAFZ,Queen's                         ,3059,1822,19,133,1237
34NAGA,Shipworth                       ,1978,1153,10,71,825
34NAGB,Springvale                      ,1907,1231,12,74,676
34NAGC,Swaffham                        ,4924,2497,27,200,2427
34NAGD,Swanton Morley                  ,1736,1176,14,69,560
34NAGE,Taverner                        ,1141,656,7,63,485
34NAGF,Templar                         ,1189,807,10,50,382
34NAGG,Thetford-Abbey                  ,3936,2512,48,345,1424
34NAGH,Thetford-Barnham Cross          ,2781,1813,20,219,968
34NAGJ,Thetford-Guildhall              ,5665,4160,40,257,1505
34NAGK,Thetford-Saxon                  ,2668,1693,22,220,975
34NAGL,Two Rivers                      ,1667,1046,10,77,621
34NAGM,Upper Wensum                    ,1490,869,14,59,621
34NAGN,Upper Yare                      ,1467,862,8,51,605
34NAGP,Watton                          ,4660,2463,15,179,2197
34NAGQ,Wayland                         ,1643,1006,68,55,637
34NAGR,Weeting                         ,1611,958,20,68,653
34NAGS,West Guiltcross                 ,1435,892,4,46,543
34NAGT,Wissey                          ,1971,958,14,76,1013
34NASS,Shipping                        ,0,0,0,0,0
34NBFA,Acle                            ,1838,1004,10,49,834
34NBFB,Aylsham                         ,4309,2494,21,109,1815
34NBFC,Blofield                        ,2916,1788,12,72,1128
34NBFD,Brundall                        ,3621,2220,18,104,1401
34NBFE,Burlingham                      ,2389,1512,17,71,877
34NBFF,Buxton                          ,1709,1106,10,51,603
34NBFG,Catton                          ,4494,3111,20,107,1383
34NBFH,Cawston                         ,1805,1193,12,51,612
34NBFJ,Coltishall                      ,1950,1119,4,60,831
34NBFK,Drayton                         ,2499,1536,15,57,963
34NBFL,Foulsham                        ,1138,695,3,48,443
34NBFM,Freethorpe                      ,1314,832,9,62,482
34NBFN,Great Witchingham               ,1604,1021,8,45,583
34NBFP,Hainford                        ,1349,911,8,34,438
34NBFQ,Hellesdon North                 ,3074,1989,22,81,1085
34NBFR,Hellesdon Southeast             ,3078,1890,17,92,1188
34NBFS,Hellesdon West                  ,3806,2163,23,99,1643
34NBFT,Hevingham                       ,1745,1124,4,72,621
34NBFU,Horsford                        ,1771,1234,19,60,537
34NBFW,Plumstead                       ,2210,1295,11,41,915
34NBFX,Rackheath                       ,2143,1323,12,62,820
34NBFY,Reedham                         ,1341,739,13,78,602
34NBFZ,Reepham                         ,1962,1159,5,55,803
34NBGA,St.Faiths                       ,1366,812,6,52,554
34NBGB,South Walsham                   ,1356,779,3,28,577
34NBGC,Spixworth                       ,3494,2548,13,110,946
34NBGD,Sprowston Central               ,3614,2247,17,111,1367
34NBGE,Sprowston East                  ,3915,2739,25,94,1176
34NBGF,Sprowston South                 ,2558,1538,18,46,1020
34NBGG,Sprowston West                  ,1562,926,5,49,636
34NBGH,Taverham                        ,5363,3669,28,116,1694
34NBGJ,Thorpe St.Andrew Northeast      ,3343,1973,14,91,1370
34NBGK,Thorpe St.Andrew Northwest      ,3068,1667,15,61,1401
34NBGL,Thorpe St.Andrew South          ,2257,1191,7,63,1066
34NBGM,Wroxham                         ,1300,606,6,31,694
34NBSS,Shipping                        ,0,0,0,0,0
34NCFA,Bradwell North                  ,4365,2719,29,179,1646
34NCFB,Bradwell South and Hopton       ,4486,2581,36,169,1905
34NCFC,Caister North                   ,3994,2390,34,205,1604
34NCFD,Caister South                   ,2966,1551,20,137,1415
34NCFE,Claydon                         ,3668,2060,37,310,1608
34NCFF,Fleggburgh                      ,1755,1094,10,65,661
34NCFG,Gorleston                       ,4047,2174,34,230,1873
34NCFH,Hemsby                          ,2234,1271,14,112,963
34NCFJ,Lichfield and Cobholm           ,3437,2116,48,297,1321
34NCFK,Lothingland                     ,4251,2742,33,192,1509
34NCFL,Magdalen East                   ,3611,1917,34,282,1694
34NCFM,Magdalen West                   ,3761,1872,49,243,1889
34NCFN,Martham                         ,2230,1321,19,93,909
34NCFP,Nelson                          ,3630,2112,44,488,1518
34NCFQ,Northgate                       ,4554,2521,59,347,2033
34NCFR,Ormesby                         ,3231,1890,23,162,1341
34NCFS,Regent                          ,4010,2337,42,521,1673
34NCFT,Rollesby                        ,1267,706,7,50,561
34NCFU,St.Andrews                      ,4057,2502,30,235,1555
34NCFW,Winterton and Somerton          ,1308,702,9,63,606
34NCFX,Yarmouth North                  ,3838,2106,55,272,1732
34NCSS,Shipping                        ,0,0,0,0,0
34NDFA,Airfield                        ,3788,2710,30,187,1078
34NDFB,Burnham                         ,1188,525,1,33,663
34NDFC,Chase                           ,3278,1981,30,173,1297
34NDFD,Clenchwarton                    ,1781,1150,8,73,631
34NDFE,Creake                          ,1485,795,12,48,690
34NDFF,Denton                          ,5096,3209,84,184,1887
34NDFG,Denver                          ,1162,701,3,62,461
34NDFH,Dersingham                      ,4150,2084,21,139,2066
34NDFJ,Docking                         ,1438,794,17,97,644
34NDFK,Downham Market                  ,6041,2948,29,216,3093
34NDFL,Emneth                          ,1752,1009,8,76,743
34NDFM,Gayton                          ,1637,977,15,64,660
34NDFN,Gaywood Central                 ,3276,2111,35,92,1165
34NDFP,Gaywood North                   ,5303,3797,26,175,1506
34NDFQ,Gaywood South                   ,5370,3273,74,444,2097
34NDFR,Grimston                        ,2182,1329,6,65,853
34NDFS,Heacham                         ,4111,1907,28,137,2204
34NDFT,Hunstanton                      ,4258,1685,24,217,2573
34NDFU,Lynn Central                    ,2513,1514,18,167,999
34NDFW,Lynn North                      ,3078,1790,42,356,1288
34NDFX,Lynn South West                 ,2940,1832,26,242,1108
34NDFY,Mershe Lande                    ,1929,1176,20,98,753
34NDFZ,Middleton                       ,1736,1047,10,67,689
34NDGA,North Coast                     ,1530,677,5,40,853
34NDGB,Priory                          ,1262,712,10,63,550
34NDGC,Rudham                          ,1121,689,14,44,432
34NDGD,St.Lawrence                     ,1722,1063,22,57,659
34NDGE,St.Margarets                    ,1793,1055,22,115,738
34NDGF,Snettisham                      ,2003,939,11,71,1064
34NDGG,Spellowfields                   ,3239,2049,22,136,1190
34NDGH,Ten Mile                        ,1834,1088,19,89,746
34NDGJ,The Walpoles                    ,2153,1355,15,104,798
34NDGK,The Woottons                    ,4882,3075,19,110,1807
34NDGL,UpwellOutwell and Delph         ,4366,2604,27,207,1762
34NDGM,Valley Hill                     ,1888,1116,14,61,772
34NDGN,Watlington                      ,2039,1318,16,55,721
34NDGP,West Walton                     ,1260,796,6,74,464
34NDGQ,West Winch                      ,2192,1264,9,66,928
34NDGR,Wiggenhall                      ,1520,944,18,68,576
34NDGS,Wissey                          ,1967,1220,5,111,747
34NDSS,Shipping                        ,0,0,0,0,0
34NEFA,Astley                          ,1809,1060,14,60,749
34NEFB,Bacton                          ,1603,893,10,70,710
34NEFC,Blakeney                        ,1405,644,2,40,761
34NEFD,Bodham                          ,1556,705,7,54,851
34NEFE,Catfield                        ,1639,1017,4,60,622
34NEFF,Chaucer                         ,1440,786,13,54,654
34NEFG,Cley                            ,1205,536,3,44,669
34NEFH,Corpusty                        ,1091,632,3,48,459
34NEFJ,Cromer                          ,4320,1979,31,174,2341
34NEFK,Erpingham                       ,1496,940,11,54,556
34NEFL,Four Stowes                     ,1508,764,1,49,744
34NEFM,Fulmodeston                     ,1339,728,9,34,611
34NEFN,Glaven                          ,3072,1461,16,84,1611
34NEFP,Happisburgh                     ,1770,888,8,76,882
34NEFQ,Hickling                        ,1569,793,12,63,776
34NEFR,Horning                         ,918,429,2,22,489
34NEFS,Horsefen                        ,1896,1000,9,68,896
34NEFT,Hoveton                         ,1648,778,3,41,870
34NEFU,Lancaster                       ,5665,3285,27,221,2380
34NEFW,Mundesley                       ,2225,1052,8,99,1173
34NEFX,Neatishead                      ,1418,845,9,52,573
34NEFY,North Walsham East              ,6018,3413,29,206,2605
34NEFZ,North Walsham West              ,1833,1018,10,65,815
34NEGA,Overstrand                      ,1124,458,10,32,666
34NEGB,Pastonacres                     ,1430,738,6,39,692
34NEGC,Roughton                        ,2099,1205,8,105,894
34NEGD,Scottow                         ,2095,1545,21,68,550
34NEGE,Sheringham                      ,5005,2203,27,150,2802
34NEGF,Stalham                         ,2319,1370,8,82,949
34NEGG,Suffield Park                   ,1616,894,2,83,722
34NEGH,The Raynhams                    ,2201,1566,26,91,635
34NEGJ,The Runtons                     ,2578,1123,15,81,1455
34NEGK,Walsingham                      ,1152,652,5,44,500
34NEGL,Wells                           ,2394,1246,16,108,1148
34NEGM,Wensum Valley                   ,1419,859,10,74,560
34NEGN,Worstead                        ,1438,890,10,47,548
34NESS,Shipping                        ,0,0,0,0,0
34NFFA,Bowthorpe                       ,7818,4710,90,583,3108
34NFFB,Catton Grove                    ,6122,3960,62,417,2162
34NFFC,Coslany                         ,6492,4154,51,353,2338
34NFFD,Crome                           ,5857,3616,24,284,2241
34NFFE,Eaton                           ,6832,3802,48,152,3030
34NFFF,Heigham                         ,6029,3648,59,411,2381
34NFFG,Henderson                       ,5939,3747,62,517,2192
34NFFH,Lakenham                        ,6111,3601,47,406,2510
34NFFJ,Mancroft                        ,6672,3526,74,566,3146
34NFFK,Mile Cross                      ,5896,3414,74,500,2482
34NFFL,Mousehold                       ,6620,4392,50,389,2228
34NFFM,Nelson                          ,5394,3547,52,278,1847
34NFFN,St.Stephen                      ,5703,3245,26,328,2458
34NFFP,Thorpe Hamlet                   ,6527,4328,87,511,2199
34NFFQ,Town Close                      ,5591,2919,42,259,2672
34NFFR,University                      ,4680,2486,43,245,2194
34NFSS,Shipping                        ,0,0,0,0,0
34NGFA,Abbey                           ,1821,1173,9,48,648
34NGFB,Abbeyfield                      ,1369,796,6,39,573
34NGFC,Beauchamp                       ,1534,933,7,34,601
34NGFD,Beckhithe                       ,4283,2688,23,104,1595
34NGFE,Beck Vale                       ,1635,961,6,49,674
34NGFF,Berners                         ,1822,1218,13,51,604
34NGFG,Boyland                         ,2053,1322,10,48,731
34NGFH,Broads                          ,1504,895,11,49,609
34NGFJ,Brookwood                       ,1714,964,8,46,750
34NGFK,Chet                            ,1998,1237,5,68,761
34NGFL,Clavering                       ,1787,1106,11,50,681
34NGFM,Cringleford and Colney          ,1854,1016,2,41,838
34NGFN,Cromwells                       ,1394,897,5,51,497
34NGFP,Crown Point                     ,969,588,1,31,381
34NGFQ,Depwade                         ,1800,1080,11,51,720
34NGFR,Dickleburgh                     ,1377,869,5,46,508
34NGFS,Diss Town                       ,5353,3105,27,152,2248
34NGFT,Ditchingham                     ,1766,1019,14,48,747
34NGFU,Forehoe                         ,1492,1013,4,46,479
34NGFW,Harleston                       ,3025,1686,12,81,1339
34NGFX,Hempnall                        ,1452,892,8,41,560
34NGFY,Hingham                         ,1673,868,12,31,805
34NGFZ,Humbleyard                      ,1293,818,2,28,475
34NGGA,Kidner                          ,1574,1048,9,55,526
34NGGB,Long Row                        ,1610,997,2,60,613
34NGGC,Marshland                       ,1437,862,10,39,575
34NGGD,Mergate                         ,2923,2016,9,71,907
34NGGE,New Costessey                   ,3622,2286,22,116,1336
34NGGF,Northfields                     ,1941,1140,3,51,801
34NGGG,Old Costessey                   ,4426,2651,28,194,1775
34NGGH,Rosebery                        ,3272,2038,12,87,1234
34NGGJ,Rustens                         ,2266,1592,16,89,674
34NGGK,Smockmill                       ,1860,1189,9,41,671
34NGGL,Springfields                    ,1219,741,3,38,478
34NGGM,Stratton                        ,2365,1470,5,56,895
34NGGN,Tasvale                         ,1744,1061,4,41,683
34NGGP,Town                            ,1608,857,8,44,751
34NGGQ,Valley                          ,1685,974,12,65,711
34NGGR,Waveney                         ,1543,869,14,47,674
34NGGS,Westwood                        ,2448,1536,12,80,912
34NGGT,Wodehouse                       ,1271,774,5,31,497
34NGSS,Shipping                        ,0,0,0,0,0
35NHFA,Central                         ,4214,2589,15,397,1625
35NHFB,Danesholme                      ,4210,3110,7,244,1100
35NHFC,East                            ,2562,1733,20,191,829
35NHFD,Hazelwood                       ,4350,3032,28,376,1318
35NHFE,Kingswood                       ,5146,3564,32,571,1582
35NHFF,Lloyds                          ,4412,2564,18,260,1848
35NHFG,Lodge Park                      ,4752,3191,18,347,1561
35NHFH,Rural East                      ,1885,1150,4,81,735
35NHFJ,Rural North                     ,1044,678,3,32,366
35NHFK,Rural West                      ,1257,773,4,33,484
35NHFL,Shire Lodge                     ,3044,2176,12,157,868
35NHFM,West                            ,3922,2897,12,254,1025
35NHSS,Shipping                        ,0,0,0,0,0
35NJFA,Abbey North                     ,2670,1746,14,148,924
35NJFB,Abbey South                     ,2910,1791,15,115,1119
35NJFC,Badby                           ,1560,1006,3,41,554
35NJFD,Barby                           ,1079,745,5,28,334
35NJFE,Boughton and Pitsford           ,1086,659,3,30,427
35NJFF,Brampton                        ,1314,858,5,33,456
35NJFG,Braunston                       ,1341,846,5,44,495
35NJFH,Brixworth                       ,3489,2443,8,93,1046
35NJFJ,Byfield                         ,1146,730,15,31,416
35NJFK,Clipston                        ,1334,840,4,39,494
35NJFL,Crick and West Haddon           ,1881,1217,6,53,664
35NJFM,Drayton                         ,5237,3918,27,256,1319
35NJFN,Everdon                         ,808,522,3,21,286
35NJFP,Flore                           ,1593,1034,5,40,559
35NJFQ,Guilsborough                    ,1296,863,9,34,433
35NJFR,Hill                            ,3092,2266,33,211,826
35NJFS,Kilsby                          ,1668,1020,4,29,648
35NJFT,Long Buckby                     ,3114,2083,6,90,1031
35NJFU,Moulton                         ,2528,1620,11,66,908
35NJFW,Overstone and Walgrave          ,1853,1209,6,66,644
35NJFX,Ravensthorpe                    ,1384,910,4,28,474
35NJFY,Spratton                        ,1402,943,13,34,459
35NJFZ,Weedon                          ,1800,1224,5,75,576
35NJGA,Welford                         ,1067,689,3,23,378
35NJGB,Woodford                        ,1927,1301,7,78,626
35NJGC,Yelvertoft                      ,1051,710,9,26,341
35NJSS,Shipping                        ,0,0,0,0,0
35NKFA,Barnwell                        ,1091,712,1,23,379
35NKFB,Brigstock                       ,1136,714,5,36,422
35NKFC,Drayton                         ,1291,806,4,36,485
35NKFD,Forest                          ,1302,829,4,36,473
35NKFE,Higham Ferrers                  ,4693,3043,30,205,1650
35NKFF,Irthlingborough                 ,5011,3317,33,188,1694
35NKFG,King's Cliffe                   ,946,592,2,33,354
35NKFH,Lower Nene                      ,1125,701,5,35,424
35NKFJ,Margaret Beaufort               ,1175,684,4,47,491
35NKFK,Oundle                          ,3180,1934,7,94,1246
35NKFL,Raunds                          ,5791,3742,19,185,2049
35NKFM,Ringstead                       ,1547,1058,7,60,489
35NKFN,Rushden East                    ,4242,2712,22,183,1530
35NKFP,Rushden North                   ,4696,3147,30,166,1549
35NKFQ,Rushden South                   ,5253,3474,20,181,1779
35NKFR,Rushden West                    ,4561,3053,17,183,1508
35NKFS,Stanwick                        ,1359,867,6,48,492
35NKFT,Thrapston                       ,3205,2149,11,100,1056
35NKFU,Willibrook                      ,1199,743,0,27,456
35NKFW,Woodford                        ,997,599,7,20,398
35NKSS,Shipping                        ,0,0,0,0,0
35NLFA,All Saints                      ,2488,1573,15,112,915
35NLFB,Avondale                        ,3314,1993,32,214,1321
35NLFC,Barton                          ,2922,1943,17,89,979
35NLFD,Buccleuch                       ,1258,789,18,23,469
35NLFE,Ise Valley                      ,5820,4280,31,189,1540
35NLFF,Kingsley                        ,3468,2455,26,108,1013
35NLFG,Latimer                         ,2787,1826,11,113,961
35NLFH,Loatland                        ,2699,1770,12,116,929
35NLFJ,Pipers Hill                     ,2417,1427,17,88,990
35NLFK,Plessy                          ,2386,1600,5,96,786
35NLFL,Queen Eleanor                   ,1089,680,4,27,409
35NLFM,St.Andrew's                     ,3823,2502,35,287,1321
35NLFN,St.Giles'                       ,3008,1997,13,104,1011
35NLFP,St.Mary's                       ,3467,2115,22,207,1352
35NLFQ,St.Michael's                    ,2679,1614,14,140,1065
35NLFR,St.Peter's                      ,2309,1333,8,64,976
35NLFS,Slade                           ,2790,1731,15,89,1059
35NLFT,Tresham                         ,2089,1287,13,88,802
35NLFU,Trinity                         ,3380,2265,17,123,1115
35NLFW,Warkton                         ,2373,1334,23,166,1039
35NLFX,Welland                         ,1724,1117,7,46,607
35NLFY,Wicksteed                       ,2384,1411,20,170,973
35NLSS,Shipping                        ,0,0,0,0,0
35NMFA,Abington                        ,5714,3817,35,348,1897
35NMFB,Billing                         ,5699,3946,45,343,1753
35NMFC,Boughton Green                  ,5003,3497,24,169,1506
35NMFD,Castle                          ,6306,3831,47,474,2475
35NMFE,Dallington and Kings Heath      ,8250,4923,61,692,3327
35NMFF,Delapre                         ,5572,3473,26,310,2099
35NMFG,Headlands                       ,5061,2868,16,167,2193
35NMFH,Kingsthorpe                     ,5121,3201,25,212,1920
35NMFJ,Links                           ,6408,4080,35,392,2328
35NMFK,Lumbertubs                      ,10022,6981,79,800,3041
35NMFL,Nene Valley                     ,15473,11318,36,573,4155
35NMFM,New Duston                      ,7870,5739,37,259,2131
35NMFN,Old Duston                      ,6033,3509,22,151,2524
35NMFP,Park                            ,7453,4857,26,202,2596
35NMFQ,St.Alban                        ,5052,3034,33,355,2018
35NMFR,St.Crispin                      ,5157,3220,35,466,1937
35NMFS,St.George                       ,5351,3282,33,249,2069
35NMFT,South                           ,5531,3411,26,272,2120
35NMFU,Thorplands                      ,6011,4376,29,488,1635
35NMFW,Welford                         ,6318,4494,29,183,1824
35NMFX,Weston                          ,7652,5287,24,300,2365
35NMSS,Shipping                        ,0,0,0,0,0
35NNFA,Astwell                         ,1388,903,8,38,485
35NNFB,Blakesley                       ,1879,1184,5,54,695
35NNFC,Blisworth                       ,1519,1022,7,38,497
35NNFD,Brackley East                   ,2729,1851,15,81,878
35NNFE,Brackley West                   ,4134,2979,48,144,1155
35NNFF,Brafield                        ,0,0,0,0,0
35NNFG,Bugbrooke                       ,2017,1453,8,66,564
35NNFH,Cogenhoe                        ,2001,1315,2,43,686
35NNFJ,Cosgrove                        ,1262,849,2,42,413
35NNFK,Danvers                         ,1607,994,7,39,613
35NNFL,Deanshanger                     ,2242,1587,10,81,655
35NNFM,Forest                          ,1660,1082,8,29,578
35NNFN,Gayton                          ,1854,1262,11,50,592
35NNFP,Grafton                         ,1168,818,6,33,350
35NNFQ,Greatworth                      ,1322,856,6,52,466
35NNFR,Hackleton                       ,1476,994,4,41,482
35NNFS,Harpole                         ,1264,837,5,35,427
35NNFT,Heyford                         ,1389,926,6,60,463
35NNFU,King's Sutton                   ,1642,1013,13,58,629
35NNFW,Kingthorn                       ,1378,846,3,31,532
35NNFX,Kislingbury                     ,950,594,2,20,356
35NNFY,Middleton Cheney                ,2859,1879,7,81,980
35NNFZ,Milton                          ,929,565,3,28,364
35NNGA,Potterspury                     ,1094,740,1,26,354
35NNGB,Rainsborough                    ,2248,1427,36,47,821
35NNGC,Roade                           ,2094,1391,3,64,703
35NNGD,Salcey                          ,1681,1224,6,53,457
35NNGE,Slapton                         ,0,0,0,0,0
35NNGF,Tove                            ,1382,910,4,31,472
35NNGG,Towcester                       ,5191,3623,23,197,1568
35NNGH,Wardoun                         ,1609,1041,12,42,568
35NNGJ,Yardley                         ,1333,876,11,31,457
35NNSS,Shipping                        ,0,0,0,0,0
35NPFA,Brickhill                       ,4381,2803,35,225,1578
35NPFB,Castle                          ,4827,3212,36,286,1615
35NPFC,Croyland                        ,4423,2647,46,317,1776
35NPFD,Earls Barton                    ,3838,2657,14,107,1181
35NPFE,Finedon                         ,3326,2073,5,96,1253
35NPFF,Great Donnington and Wilby      ,1457,914,10,31,543
35NPFG,Hemmingwell                     ,4845,3120,31,315,1725
35NPFH,Irchester                       ,3963,2685,22,177,1278
35NPFJ,North                           ,1731,1089,4,52,642
35NPFK,Queensway                       ,4496,3140,34,308,1356
35NPFL,Redwell                         ,5621,4209,28,207,1412
35NPFM,South                           ,1556,1029,9,30,527
35NPFN,Swanspool                       ,4670,2615,24,206,2055
35NPFP,West                            ,1399,844,3,25,555
35NPFQ,Wollaston                       ,2761,1792,12,84,969
35NPSS,Shipping                        ,0,0,0,0,0
36NQFA,Alnwick Castle                  ,2580,1450,31,76,1130
36NQFB,Alnwick Clayport                ,1549,911,42,165,638
36NQFC,Alnwick Hotspur                 ,1805,1034,32,55,771
36NQFD,Amble East                      ,2647,1459,65,200,1188
36NQFE,Amble West                      ,1991,1255,24,94,736
36NQFF,Craster and Rennington          ,0,0,0,0,0
36NQFG,Elsdon                          ,0,0,0,0,0
36NQFH,Embleton                        ,1274,673,15,37,601
36NQFJ,Harbottle                       ,1021,644,18,27,377
36NQFK,Hedgeley                        ,0,0,0,0,0
36NQFL,Lesbury                         ,1495,819,22,61,676
36NQFM,Longframlington                 ,899,518,2,16,381
36NQFN,Longhoughton                    ,1205,843,20,27,362
36NQFP,Rothbury                        ,2076,1136,20,59,940
36NQFQ,Shilbottle                      ,2354,1344,37,110,1010
36NQFR,Warkworth                       ,1941,1111,10,69,830
36NQFS,Whittingham                     ,1494,847,22,46,647
36NQSS,Shipping                        ,0,0,0,0,0
36NRFA,Bamburgh                        ,0,0,0,0,0
36NRFB,Beadnell                        ,1357,727,5,42,630
36NRFC,Belford                         ,950,519,9,31,431
36NRFD,Chatton                         ,0,0,0,0,0
36NRFE,Cheviot                         ,1061,688,10,32,373
36NRFF,Edward                          ,1397,844,24,103,553
36NRFG,Elizabeth                       ,2296,1280,13,62,1016
36NRFH,Ford                            ,978,627,11,19,351
36NRFJ,Islandshire                     ,2108,1288,26,65,820
36NRFK,Milfield                        ,884,506,14,27,378
36NRFL,Norhamshire                     ,1305,737,16,35,568
36NRFM,North Sunderland                ,1508,816,12,45,692
36NRFN,Seton                           ,1505,784,11,68,721
36NRFP,Spittal                         ,2579,1676,31,145,903
36NRFQ,Tower                           ,2147,1391,30,145,756
36NRFR,Wooler                          ,1656,877,8,36,779
36NRSS,Shipping                        ,0,0,0,0,0
36NSFA,Central                         ,3380,1996,40,189,1384
36NSFB,Cowpen                          ,3409,1763,82,381,1646
36NSFC,Cramlington East                ,3612,1991,50,250,1621
36NSFD,Cramlington South East          ,4048,2969,49,144,1079
36NSFE,Croft                           ,2709,1507,60,295,1202
36NSFF,Hartford and West Cramlington   ,3212,2063,71,285,1149
36NSFG,Hartley                         ,4217,2513,49,179,1704
36NSFH,Holywell                        ,2902,1744,42,151,1158
36NSFJ,Isabella                        ,3519,2016,77,284,1503
36NSFK,Kitty Brewster                  ,2371,1377,43,203,994
36NSFL,Nesham and New Delaval          ,3768,2504,89,275,1264
36NSFM,Parkside                        ,7049,5543,86,296,1506
36NSFN,Plessey                         ,2931,1365,49,210,1566
36NSFP,Seaton Delaval                  ,3135,1900,36,149,1235
36NSFQ,Seghill                         ,2242,1382,40,129,860
36NSFR,Village                         ,3959,2673,57,166,1286
36NSFS,Wensleydale                     ,5858,4109,93,220,1749
36NSSS,Shipping                        ,0,0,0,0,0
36NTFA,Chevington                      ,2389,1246,52,199,1143
36NTFB,Ellington                       ,2250,1441,30,115,809
36NTFC,Hartburn                        ,0,0,0,0,0
36NTFD,HebronHepscott and Mitford      ,1766,768,10,35,998
36NTFE,Heddon-On-The-Wall              ,1291,743,6,42,548
36NTFF,Longhorsley                     ,1823,1154,14,46,669
36NTFG,Lynemouth                       ,1652,802,43,122,850
36NTFH,Morpeth Central                 ,1999,1023,11,71,976
36NTFJ,Morpeth Kirkhill                ,2375,1386,34,81,989
36NTFK,Morpeth North                   ,2799,1498,20,54,1301
36NTFL,Morpeth South                   ,1913,1056,26,91,857
36NTFM,Morpeth Stobhill                ,2631,1489,34,141,1142
36NTFN,Pegswood                        ,2766,1672,47,193,1094
36NTFP,Ponteland East                  ,2528,1387,16,53,1141
36NTFQ,Ponteland North                 ,1467,840,17,41,627
36NTFR,Ponteland South                 ,2416,1377,17,50,1039
36NTFS,Ponteland West                  ,2766,1597,13,61,1169
36NTFT,Stamfordham                     ,1648,805,4,25,843
36NTFU,Stannington                     ,1369,634,7,29,735
36NTFW,Ulgham                          ,2304,1341,49,146,963
36NTFX,Whalton                         ,823,541,5,20,282
36NTSS,SHIPPING                        ,0,0,0,0,0
36NUFA,Acomb With Sandhoe              ,1300,753,8,51,547
36NUFB,Allendale                       ,1744,987,12,56,757
36NUFC,Bardon Mill                     ,1686,1041,17,52,645
36NUFD,Bellingham                      ,964,580,10,25,384
36NUFE,Broomhaugh and Riding           ,0,0,0,0,0
36NUFF,Broomley and Stocksfield        ,2458,1440,9,54,1018
36NUFG,Castle                          ,1032,688,13,37,344
36NUFH,Chesters                        ,929,529,2,10,400
36NUFJ,Chollerton with Whittington     ,1612,1029,18,43,583
36NUFK,Corbridge                       ,2903,1493,19,68,1410
36NUFL,East Tynedale                   ,1010,669,12,24,341
36NUFM,Gilesgate                       ,998,562,10,30,436
36NUFN,Haltwhistle                     ,3052,1765,34,104,1287
36NUFP,Haydon                          ,1639,985,15,53,654
36NUFQ,Hencotes                        ,2641,1524,19,99,1117
36NUFR,Leazes                          ,2486,1435,11,48,1051
36NUFS,Mickley                         ,831,564,8,34,267
36NUFT,Ovingham                        ,971,593,6,32,378
36NUFU,Priestpopple                    ,2943,1611,18,101,1332
36NUFW,Prudhoe North                   ,1768,975,16,102,793
36NUFX,Prudhoe South                   ,2974,1496,32,113,1478
36NUFY,Prudhoe West                    ,2265,1584,15,86,681
36NUFZ,Redesdale                       ,0,0,0,0,0
36NUGA,Slaley and Hexhamshire          ,941,574,2,15,367
36NUGB,South Tynedale                  ,1568,983,4,46,585
36NUGC,Tipalt                          ,0,0,0,0,0
36NUGD,Upper North Tyne                ,1348,847,8,26,501
36NUGE,Wanney                          ,0,0,0,0,0
36NUGF,Warden and Newbrough            ,868,553,8,21,315
36NUGG,Wark                            ,0,0,0,0,0
36NUGH,West Tynedale                   ,1546,949,24,68,597
36NUGJ,Wylam                           ,1710,996,8,45,714
36NUSS,SHIPPING                        ,0,0,0,0,0
36NWFA,Bedlington Central              ,3916,2317,62,195,1599
36NWFB,Bedlington East                 ,3405,1983,51,203,1422
36NWFC,Bedlington West                 ,3246,1865,52,186,1381
36NWFD,Bothal                          ,4426,2361,50,203,2065
36NWFE,Central                         ,2824,1544,66,186,1280
36NWFF,Choppington                     ,1836,965,41,181,871
36NWFG,College                         ,2641,1380,47,192,1261
36NWFH,Guide Post                      ,3060,1868,44,130,1192
36NWFJ,Haydon                          ,2863,1751,58,160,1112
36NWFK,Hirst                           ,3156,1733,108,370,1423
36NWFL,Newbiggin East                  ,3098,1533,51,301,1565
36NWFM,Newbiggin West                  ,2595,1337,53,200,1258
36NWFN,Park                            ,2544,1387,47,203,1157
36NWFP,Seaton                          ,3873,2336,78,240,1537
36NWFQ,Sleekburn                       ,2897,1590,44,222,1307
36NWFR,Stakeford                       ,2588,1578,31,134,1010
36NWSS,SHIPPING                        ,0,0,0,0,0
37NXFA,Aire Valley                     ,2181,1329,11,50,852
37NXFB,Bentham                         ,2296,1374,25,43,922
37NXFC,Bolton Abbey                    ,1014,601,1,14,413
37NXFD,Calton                          ,1198,746,5,20,452
37NXFE,Clapham                         ,1023,622,8,14,401
37NXFF,Cowling                         ,1510,1062,4,52,448
37NXFG,Embasy-with-Eastby              ,1468,837,0,31,631
37NXFH,Gargrave                        ,1332,674,6,20,658
37NXFJ,Glusburn                        ,3340,1999,17,87,1341
37NXFK,Grassington                     ,1246,633,5,21,613
37NXFL,Hellifield                      ,1190,745,6,21,445
37NXFM,Ingleborough                    ,2369,1396,17,48,973
37NXFN,Penyghent                       ,1395,843,6,19,552
37NXFP,Ribbleside                      ,894,541,4,18,353
37NXFQ,Settle                          ,2295,1300,7,43,995
37NXFR,Skipton Central                 ,1007,593,3,22,414
37NXFS,Skipton East                    ,3843,2392,28,186,1451
37NXFT,Skipton North                   ,1981,1030,3,34,951
37NXFU,Skipton South                   ,1784,1139,15,85,645
37NXFW,Skipton South-West              ,889,537,5,38,352
37NXFX,Skipton West                    ,1559,919,16,30,640
37NXFY,Sutton                          ,2630,1654,16,63,976
37NXFZ,Upper Wharfedale                ,1318,764,5,20,554
37NXGA,West Craven                     ,1275,777,9,44,498
37NXSS,Shipping                        ,0,0,0,0,0
37NYFA,Appleton Wiske                  ,1309,857,9,33,452
37NYFB,Bedale                          ,2693,1578,12,66,1115
37NYFC,Brompton                        ,1699,1125,8,62,574
37NYFD,Broughton and Greenhow          ,1822,1101,17,48,721
37NYFE,Carlton Miniott                 ,1525,1004,11,34,521
37NYFF,Crakehall                       ,1353,843,7,32,510
37NYFG,Crayke                          ,1051,624,6,28,427
37NYFH,Easingwold                      ,2974,1621,10,51,1353
37NYFJ,Great Ayton                     ,3922,2297,34,126,1625
37NYFK,Helperby                        ,1264,835,2,29,429
37NYFL,Hillside                        ,1187,746,12,18,441
37NYFM,Huby-Sutton                     ,1396,917,8,47,479
37NYFN,Leeming                         ,2286,1803,19,41,483
37NYFP,Leeming Bar                     ,1467,874,6,30,593
37NYFQ,Morton-on-Swale                 ,1248,825,5,21,423
37NYFR,Northallerton North East        ,2258,1357,6,99,901
37NYFS,Northallerton South East        ,2998,2027,20,138,971
37NYFT,Northallerton West              ,2482,1467,13,65,1015
37NYFU,Osmotherley                     ,1017,654,7,17,363
37NYFW,Romanby                         ,2464,1452,15,40,1012
37NYFX,Romanby Broomfield              ,1801,1144,9,24,657
37NYFY,Rudby                           ,2211,1360,13,51,851
37NYFZ,Shipton                         ,1679,1191,10,47,488
37NYGA,Sowerby                         ,2833,1721,17,84,1112
37NYGB,Stillington                     ,1100,681,9,26,419
37NYGC,Stokesley                       ,3836,2237,24,157,1599
37NYGD,Swainby                         ,1310,799,6,33,511
37NYGE,Tanfield                        ,1055,650,14,24,405
37NYGF,The Cowtons                     ,1310,883,7,33,427
37NYGG,The Thorntons                   ,1332,899,7,23,433
37NYGH,Thirsk                          ,3383,2063,31,154,1320
37NYGJ,Tollerton                       ,1198,748,5,22,450
37NYGK,Topcliffe                       ,1660,1178,29,50,482
37NYGL,Whitestonecliffe                ,1250,713,14,18,537
37NYSS,Shipping                        ,0,0,0,0,0
37NZFA,Almscliffe                      ,1975,1175,4,51,800
37NZFB,Bilton                          ,6019,3869,22,166,2150
37NZFC,Bishop Monkton                  ,1948,1183,6,38,765
37NZFD,Boroughbridge                   ,2350,1448,10,53,902
37NZFE,Claro                           ,2027,1219,11,33,808
37NZFF,Duchy                           ,6711,4284,28,212,2427
37NZFG,East Central                    ,5317,3160,26,224,2157
37NZFH,Fountains                       ,1805,1105,9,36,700
37NZFJ,Granby                          ,5798,3681,46,261,2117
37NZFK,Harlow                          ,6094,3437,39,117,2657
37NZFL,Killinghall                     ,3605,2574,15,60,1031
37NZFM,Kirkby Malzeard                 ,1879,1175,15,31,704
37NZFN,Knaresborough East              ,5712,3640,23,126,2072
37NZFP,Knaresborough West              ,5514,3219,22,146,2295
37NZFQ,Lower Nidderdale                ,1878,1158,8,31,720
37NZFR,Marston Moor                    ,2054,1364,3,40,690
37NZFS,Mashamshire                     ,1829,1076,10,27,753
37NZFT,Nether Poppleton                ,2023,1174,7,28,849
37NZFU,Newby                           ,2007,1312,10,33,695
37NZFW,New Park                        ,3031,2119,23,86,912
37NZFX,Nidd Valley                     ,2388,1521,27,41,867
37NZFY,Ouseburn                        ,1940,1168,3,44,772
37NZFZ,Pannal                          ,5273,2980,18,82,2293
37NZGA,Pateley Bridge                  ,2064,1251,8,45,813
37NZGB,Ripon East                      ,5517,3338,27,180,2179
37NZGC,Ripon West                      ,5772,3595,33,134,2177
37NZGD,Spofforth                       ,2079,1242,12,43,837
37NZGE,Starbeck                        ,5184,3299,24,138,1885
37NZGF,Upper Poppleton                 ,2386,1288,7,56,1098
37NZGG,Wathvale                        ,1715,1076,16,49,639
37NZGH,Wedderburn                      ,6020,3418,18,125,2602
37NZGJ,West Central                    ,6089,3603,39,258,2486
37NZGK,Wharfedale Moors                ,1635,1058,5,30,577
37NZSS,Shipping                        ,0,0,0,0,0
37PAFA,Askrigg                         ,828,475,4,6,353
37PAFB,Aysgarth                        ,906,530,6,11,376
37PAFC,Barton                          ,1165,700,9,34,465
37PAFD,Bolton Manor                    ,0,0,0,0,0
37PAFE,Catterick With Tunstall         ,2450,1676,22,82,774
37PAFF,Colburn                         ,3369,2391,55,146,978
37PAFG,Croft on Tees                   ,0,0,0,0,0
37PAFH,Grinton and Upper Swaledale     ,0,0,0,0,0
37PAFJ,Hawes and High Abbotside        ,1081,670,0,17,411
37PAFK,Hipswell                        ,2439,1792,52,64,647
37PAFL,Kirby Hill                      ,1012,635,7,20,377
37PAFM,Leyburn                         ,1744,908,11,30,836
37PAFN,Lower Dale                      ,925,603,5,28,322
37PAFP,Lower Swaledale                 ,1195,651,14,24,544
37PAFQ,Middleham and Coverdale         ,1165,702,6,40,463
37PAFR,Reeth                           ,1376,816,9,20,560
37PAFS,Richmond Central                ,1678,980,17,61,698
37PAFT,Richmond East                   ,2973,1788,37,84,1185
37PAFU,Richmond West                   ,1815,1139,26,96,676
37PAFW,St.Agathas                      ,867,508,7,24,359
37PAFX,St.Michael with St.Luke         ,1639,992,14,49,647
37PAFY,Scorton                         ,0,0,0,0,0
37PAFZ,Scotton                         ,2739,2150,23,65,589
37PAGA,Stanwick                        ,1053,648,8,33,405
37PAGB,Swaleside                       ,1955,1239,18,54,716
37PAGC,Urevale                         ,944,545,5,14,399
37PASS,Shipping                        ,0,0,0,0,0
37PBFA,Amotherby                       ,1844,1138,13,51,706
37PBFB,Ampleforth                      ,1312,834,5,22,478
37PBFC,Birdsall                        ,1603,1002,10,46,601
37PBFD,Clifton Without                 ,3089,2110,20,89,979
37PBFE,Dales                           ,1359,809,12,24,550
37PBFF,Ebberston                       ,1191,668,4,22,523
37PBFG,Haxby North East                ,3714,2341,21,71,1373
37PBFH,Haxby West                      ,3567,2304,15,69,1263
37PBFJ,Helmsley                        ,1569,880,8,23,689
37PBFK,Hovingham                       ,1956,1179,3,34,777
37PBFL,Huntington North                ,3059,1821,16,61,1238
37PBFM,Huntington South                ,4479,3041,21,107,1438
37PBFN,Kirby Misperton                 ,1753,1042,11,41,711
37PBFP,Kirkbymoorside                  ,3212,1872,25,70,1340
37PBFQ,Malton                          ,3645,2072,15,103,1573
37PBFR,New Earswick                    ,1724,966,11,54,758
37PBFS,Norton                          ,5134,3317,24,110,1817
37PBFT,Osbaldwick and Heworth          ,4725,2897,21,81,1828
37PBFU,Pickering                       ,5234,2897,26,130,2337
37PBFW,Rawcliffe                       ,2884,1956,11,73,928
37PBFX,Rillington                      ,2090,1262,12,66,828
37PBFY,Sherburn                        ,1932,1227,11,67,705
37PBFZ,Sheriff Hutton                  ,1888,1124,14,51,764
37PBGA,Skelton                         ,1221,788,6,42,433
37PBGB,Stockton and Bossall            ,1989,1284,12,36,705
37PBGC,Strensall                       ,3415,2282,30,87,1133
37PBGD,Thornton Dale                   ,1649,847,5,33,802
37PBGE,Wigginton                       ,3019,2079,16,67,940
37PBSS,Shipping                        ,0,0,0,0,0
37PCFA,Ayton                           ,2073,1094,7,46,979
37PCFB,Castle                          ,5118,3221,58,488,1897
37PCFC,Cayton                          ,3642,2152,22,109,1490
37PCFD,Central                         ,4634,3113,38,253,1521
37PCFE,Danby                           ,2210,1281,19,47,929
37PCFF,Derwent                         ,1909,1117,7,43,792
37PCFG,Eastfield                       ,4826,2848,37,313,1978
37PCFH,Eskdaleside                     ,3548,1921,27,92,1627
37PCFJ,Falsgrave                       ,5508,3067,49,339,2441
37PCFK,Filey                           ,5672,2495,37,256,3177
37PCFL,Fylingdales                     ,1789,976,16,53,813
37PCFM,Hertford                        ,3510,1872,22,116,1638
37PCFN,Lindhead                        ,2001,1092,14,59,909
37PCFP,Mayfield                        ,6028,3260,54,272,2768
37PCFQ,Mulgrave                        ,2832,1574,46,118,1258
37PCFR,Newby                           ,3644,2045,18,76,1599
37PCFS,Northstead                      ,4821,2646,41,204,2175
37PCFT,Scalby                          ,4011,1888,17,88,2123
37PCFU,Seamer                          ,2926,1716,12,71,1210
37PCFW,Streonshalh                     ,4986,2932,43,372,2054
37PCFX,Weaponness                      ,6162,2705,39,252,3457
37PCFY,Woodlands                       ,5357,2895,37,255,2462
37PCSS,Shipping                        ,0,0,0,0,0
37PDFA,Appleton Roebuck                ,1358,844,4,24,514
37PDFB,Askham Bryan                    ,974,577,6,16,397
37PDFC,Barlby with Osgodby             ,3097,2029,32,110,1068
37PDFD,Beal                            ,1430,930,2,56,500
37PDFE,Bishopthorpe                    ,2576,1556,11,47,1020
37PDFF,Brayton                         ,4450,3002,56,158,1448
37PDFG,Byram cum Sutton                ,1117,695,7,60,422
37PDFH,Camblesforth                    ,1650,1180,21,63,470
37PDFJ,Carlton                         ,1607,1008,8,64,599
37PDFK,Cawood With Wistow              ,1863,1226,19,69,637
37PDFL,Church Fenton                   ,1640,1137,9,50,503
37PDFM,Copmanthorpe                    ,3119,2111,8,83,1008
37PDFN,Dunnington                      ,2621,1537,8,39,1084
37PDFP,Eggborough                      ,1246,787,6,37,459
37PDFQ,Escrick                         ,1587,973,13,28,614
37PDFR,Fairburn with Brotherton        ,1050,657,17,71,393
37PDFS,Fulford                         ,2201,1249,8,37,952
37PDFT,Hambleton                       ,1628,1078,4,40,550
37PDFU,Hemingbrough                    ,2044,1379,14,79,665
37PDFW,Heslington                      ,1067,536,12,33,531
37PDFX,Monk Fryston                    ,1270,805,5,34,465
37PDFY,North Duffield                  ,983,620,11,28,363
37PDFZ,Riccall with Kelfield           ,1810,1183,16,55,627
37PDGA,Selby Central                   ,1904,1156,16,109,748
37PDGB,Selby North                     ,3343,1973,44,252,1370
37PDGC,Selby South                     ,2053,1175,24,145,878
37PDGD,Selby West                      ,2786,1644,35,79,1142
37PDGE,Sherburn in Elmet               ,4346,2889,25,166,1457
37PDGF,South Milford                   ,1413,917,3,29,496
37PDGG,Stutton with Hazlewood          ,1530,919,5,43,611
37PDGH,Tadcaster East                  ,2191,1469,11,60,722
37PDGJ,Tadcaster West                  ,3060,1935,18,58,1125
37PDGK,Thorpe Willoughby               ,2210,1478,15,73,732
37PDGL,Wheldrake with Elvington        ,1877,1181,4,39,696
37PDGM,Whitley                         ,2448,1528,10,76,920
37PDSS,Shipping                        ,0,0,0,0,0
37PEFA,Acomb                           ,5558,3360,41,286,2198
37PEFB,Beckfield                       ,5261,3519,35,172,1742
37PEFC,Bishophill                      ,4807,2792,27,239,2015
37PEFD,Bootham                         ,4872,3123,29,332,1749
37PEFE,Clifton                         ,5300,3247,56,386,2053
37PEFF,Fishergate                      ,5869,3434,32,226,2435
37PEFG,Foxwood                         ,7316,4980,52,327,2336
37PEFH,Guildhall                       ,5616,3364,51,333,2252
37PEFJ,Heworth                         ,5166,3061,37,206,2105
37PEFK,Holgate                         ,5237,3201,30,202,2036
37PEFL,Knavesmire                      ,4949,3202,40,205,1747
37PEFM,Micklegate                      ,5203,2931,23,154,2272
37PEFN,Monk                            ,5115,2876,23,205,2239
37PEFP,Walmgate                        ,5459,3380,37,302,2079
37PEFQ,Westfield                       ,4845,2745,36,268,2100
37PESS,Shipping                        ,0,0,0,0,0
38PFFA,Hucknall Central                ,5080,3093,33,293,1987
38PFFB,Hucknall East                   ,4704,2710,34,335,1994
38PFFC,Hucknall North                  ,5957,3769,59,339,2188
38PFFD,Hucknall West                   ,7472,5046,67,379,2426
38PFFE,Jacksdale                       ,2588,1611,21,145,977
38PFFF,Kirkby in Ashfield Central      ,4673,2752,32,248,1921
38PFFG,Kirkby in Ashfield East         ,4783,2721,47,363,2062
38PFFH,Kirkby in Ashfield West         ,5343,3177,55,341,2166
38PFFJ,Selston                         ,5101,3016,39,237,2085
38PFFK,Sutton in Ashfield Central      ,8640,4937,96,503,3703
38PFFL,Sutton in Ashfield East         ,7949,4651,118,576,3298
38PFFM,Sutton in Ashfield North        ,8037,4719,89,453,3318
38PFFN,Sutton in Ashfield West         ,8001,4975,97,449,3026
38PFFP,Underwood                       ,2259,1451,22,91,808
38PFFQ,Woodhouse                       ,6074,3677,49,303,2397
38PFSS,Shipping                        ,0,0,0,0,0
38PGFA,Beckingham                      ,1809,1096,11,70,713
38PGFB,Blyth                           ,1548,990,9,46,558
38PGFC,Carlton                         ,5036,2979,57,313,2057
38PGFD,Clayworth                       ,1614,1001,16,65,613
38PGFE,East Markham                    ,1638,996,5,40,642
38PGFF,East Retford East               ,5721,3530,44,265,2191
38PGFG,East Retford North              ,5495,3018,48,318,2477
38PGFH,East Retford West               ,5556,3467,57,306,2089
38PGFJ,Elkesley                        ,1378,859,16,66,519
38PGFK,Everton                         ,1715,1070,14,61,645
38PGFL,Harworth East                   ,3048,1712,29,230,1336
38PGFM,Harworth West                   ,3067,1783,26,186,1284
38PGFN,Hodsock                         ,2140,1255,38,191,885
38PGFP,Misterton                       ,1857,1104,14,112,753
38PGFQ,Rampton                         ,1825,883,12,65,942
38PGFR,Ranskill                        ,1461,902,11,66,559
38PGFS,Sturton                         ,2025,1273,29,106,752
38PGFT,Sutton                          ,1642,977,3,55,665
38PGFU,Trent                           ,1211,740,6,46,471
38PGFW,Tuxford                         ,2020,1261,24,119,759
38PGFX,Welbeck                         ,1187,664,14,68,523
38PGFY,Worksop East                    ,5049,2881,62,266,2168
38PGFZ,Worksop North                   ,4555,2937,44,236,1618
38PGGA,Worksop North East              ,5471,3429,69,229,2042
38PGGB,Worksop North West              ,3889,2375,57,335,1514
38PGGC,Worksop South                   ,6060,3730,62,314,2330
38PGGD,Worksop South East              ,5650,2961,113,553,2689
38PGSS,Shipping                        ,0,0,0,0,0
38PHFA,Attenborough                    ,3897,2550,30,130,1347
38PHFB,Awsworth and Cossall            ,2507,1724,25,108,783
38PHFC,Beeston Central                 ,5476,3238,44,279,2238
38PHFD,Beeston North-East              ,4549,2679,28,271,1870
38PHFE,Beeston North-West              ,2879,1801,13,92,1078
38PHFF,Beeston Rylands                 ,3552,2378,26,176,1174
38PHFG,Bramcote                        ,4730,2982,21,130,1748
38PHFH,Brinsley                        ,2037,1195,19,67,842
38PHFJ,Chilwell East                   ,4887,2917,19,150,1970
38PHFK,Chilwell West                   ,4781,2941,38,257,1840
38PHFL,Eastwood East                   ,3653,2299,28,186,1354
38PHFM,Eastwood North                  ,1976,1219,14,122,757
38PHFN,Eastwood South                  ,3613,2045,35,252,1568
38PHFP,Greasley                        ,8226,5354,55,308,2872
38PHFQ,Kimberley                       ,5075,3399,37,230,1676
38PHFR,Nuthall                         ,4333,2717,16,128,1616
38PHFS,Stapleford East                 ,4547,2786,30,156,1761
38PHFT,Stapleford North                ,4821,3100,38,264,1721
38PHFU,Stapleford West                 ,4605,3066,40,236,1539
38PHFW,Strelley and Trowell            ,2181,1472,7,80,709
38PHFX,Toton                           ,4551,3203,14,126,1348
38PHSS,Shipping                        ,0,0,0,0,0
38PJFA,Bestwood Park                   ,3525,2491,19,223,1034
38PJFB,Bonington                       ,4076,2345,24,172,1731
38PJFC,Burton Joyce and Stoke Bardolph ,3079,1817,10,87,1262
38PJFD,Calverton                       ,5181,3151,33,187,2030
38PJFE,Carlton                         ,4827,3119,21,219,1708
38PJFF,Carlton Hill                    ,4900,3300,33,235,1600
38PJFG,Cavendish                       ,2947,1788,16,199,1159
38PJFH,Conway                          ,2952,1689,23,159,1263
38PJFJ,Gedling                         ,4551,2888,17,155,1663
38PJFK,Killisick                       ,3298,1989,25,172,1309
38PJFL,Kingswell                       ,4771,3119,21,149,1652
38PJFM,Lambley                         ,1045,574,5,24,471
38PJFN,Mapperley Plains                ,4540,3169,37,152,1371
38PJFP,Netherfield                     ,4679,3206,30,336,1473
38PJFQ,Newstead                        ,1581,873,10,104,708
38PJFR,Oxclose                         ,2796,1851,20,158,945
38PJFS,Phoenix                         ,2545,1750,19,146,795
38PJFT,Porchester                      ,4380,2890,21,139,1490
38PJFU,Priory                          ,2398,1611,9,109,787
38PJFW,Ravenshead                      ,4695,3017,21,115,1678
38PJFX,St.James                        ,4375,2938,41,137,1437
38PJFY,St.Mary's                       ,5441,3555,29,230,1886
38PJFZ,Woodborough                     ,1391,824,3,26,567
38PJGA,Woodthorpe                      ,4921,3083,31,132,1838
38PJSS,Shipping                        ,0,0,0,0,0
38PKFA,Berry Hill                      ,3312,1932,15,101,1380
38PKFB,Birklands                       ,5823,3294,88,348,2529
38PKFC,Broomhill                       ,3790,2247,40,252,1543
38PKFD,Cumberlands                     ,3663,1960,40,265,1703
38PKFE,Eakring                         ,3539,2122,47,214,1417
38PKFF,Forest Town                     ,5771,3556,54,325,2215
38PKFG,Ladybrook                       ,5862,3401,99,463,2461
38PKFH,Leeming                         ,4300,2799,46,174,1501
38PKFJ,Lindhurst                       ,2880,1595,29,215,1285
38PKFK,Manor                           ,5473,3474,56,229,1999
38PKFL,Meden                           ,4391,2324,59,286,2067
38PKFM,Northfield                      ,2991,1563,52,294,1428
38PKFN,Oakham                          ,5475,3440,20,179,2035
38PKFP,Oak Tree                        ,4502,2538,54,247,1964
38PKFQ,Pleasleyhill                    ,4104,2196,76,340,1908
38PKFR,Ravensdale                      ,5915,3341,100,532,2574
38PKFS,Sherwood                        ,3349,1838,46,212,1511
38PKFT,Titchfield                      ,4275,2696,56,375,1579
38PKSS,Shipping                        ,0,0,0,0,0
38PLFA,Beacon                          ,3737,2472,31,157,1265
38PLFB,Bilsthorpe                      ,2784,1639,26,109,1145
38PLFC,Blidworth                       ,3318,1859,40,220,1459
38PLFD,Boughton                        ,4398,2699,52,325,1699
38PLFE,Bridge                          ,4356,2633,50,278,1723
38PLFF,Bullpit-Pinfold                 ,3553,2053,35,118,1500
38PLFG,Castle                          ,4805,2939,48,275,1866
38PLFH,Caunton                         ,1525,967,8,45,558
38PLFJ,Clipstone                       ,2789,1517,32,152,1272
38PLFK,Collingham                      ,2326,1268,17,89,1058
38PLFL,Devon                           ,4228,2269,53,339,1959
38PLFM,Dover Beck                      ,1631,1061,13,29,570
38PLFN,Edwinstowe                      ,4012,2347,34,158,1665
38PLFP,Elston                          ,1011,638,12,38,373
38PLFQ,Farndon                         ,1848,1080,11,67,768
38PLFR,Farnsfield                      ,3231,1965,20,84,1266
38PLFS,Lowdham                         ,1791,1149,1,44,642
38PLFT,Magnus                          ,2737,1583,28,133,1154
38PLFU,Meering                         ,1301,834,7,46,467
38PLFW,Milton-Lowfield                 ,4110,2775,49,170,1335
38PLFX,Muskham                         ,1700,1049,6,59,651
38PLFY,Ollerton North                  ,2605,1418,15,171,1187
38PLFZ,Ollerton South                  ,2806,1530,30,149,1276
38PLGA,Rainworth                       ,3577,2204,34,175,1373
38PLGB,Rufford                         ,1542,957,17,85,585
38PLGC,Southwell East                  ,3134,1899,19,94,1235
38PLGD,Southwell West                  ,2498,1482,20,72,1016
38PLGE,Sutton On Trent                 ,1471,861,10,41,610
38PLGF,Trent                           ,1682,1032,10,40,650
38PLGG,Winthorpe                       ,1848,1029,21,81,819
38PLSS,Shipping                        ,0,0,0,0,0
38PMFA,Abbey                           ,7737,4346,49,341,3391
38PMFB,Aspley                          ,7934,4281,87,806,3653
38PMFC,Basford                         ,7873,4746,87,559,3127
38PMFD,Beechdale                       ,7505,3542,46,425,3963
38PMFE,Bestwood Park                   ,7131,4521,59,655,2610
38PMFF,Bilborough                      ,6012,3083,53,382,2929
38PMFG,Bridge                          ,7021,4089,71,838,2932
38PMFH,Bulwell East                    ,8007,4510,65,541,3497
38PMFJ,Bulwell West                    ,9202,5643,87,788,3559
38PMFK,Byron                           ,10730,7017,111,906,3713
38PMFL,Clifton East                    ,6509,3767,57,427,2742
38PMFM,Clifton West                    ,7955,5005,54,506,2950
38PMFN,Forest                          ,8024,4842,123,1141,3182
38PMFP,Greenwood                       ,8463,5122,63,726,3341
38PMFQ,Lenton                          ,5480,3023,71,986,2457
38PMFR,Manvers                         ,8226,4418,79,999,3808
38PMFS,Mapperley                       ,8182,5177,59,570,3005
38PMFT,Park                            ,7020,4511,53,697,2509
38PMFU,Portland                        ,7561,4722,45,568,2839
38PMFW,Radford                         ,6620,3952,125,1064,2668
38PMFX,Robin Hood                      ,9272,5163,53,673,4109
38PMFY,St.Anne's                       ,6565,3658,102,897,2907
38PMFZ,Sherwood                        ,8327,5147,72,546,3180
38PMGA,Strelley                        ,6591,3491,94,838,3100
38PMGB,Trent                           ,6796,4027,64,903,2769
38PMGC,Wilford                         ,7760,4655,51,420,3105
38PMGD,Wollaton                        ,10078,5686,54,401,4392
38PMSS,Shipping                        ,0,0,0,0,0
38PNFA,Abbey                           ,4357,2751,22,157,1606
38PNFB,Ash Lea                         ,4377,3093,36,268,1284
38PNFC,Bingham                         ,5691,3631,20,187,2060
38PNFD,Bishop                          ,1384,884,6,41,500
38PNFE,Cranmer                         ,1625,902,12,41,723
38PNFF,Dayncourt                       ,2239,1335,9,61,904
38PNFG,Edwalton                        ,3919,2051,16,101,1868
38PNFH,Gotham                          ,1730,1102,8,57,628
38PNFJ,Lady Bay                        ,4234,2896,38,265,1338
38PNFK,Lamcote                         ,2124,1287,6,41,837
38PNFL,Leake                           ,4503,2805,26,109,1698
38PNFM,Leys                            ,2727,1662,16,80,1065
38PNFN,Lutterell                       ,6746,4341,25,211,2405
38PNFP,Malkin                          ,3023,1891,14,84,1132
38PNFQ,Manor                           ,1325,821,7,46,504
38PNFR,Melton                          ,3747,2289,16,117,1458
38PNFS,Musters                         ,4072,2677,29,395,1395
38PNFT,Nevile                          ,1497,984,9,28,513
38PNFU,North Keyworth                  ,1616,983,2,24,633
38PNFW,Oak                             ,1673,978,1,39,695
38PNFX,Packman                         ,2660,1646,14,80,1014
38PNFY,Rancliffe                       ,1357,866,10,34,491
38PNFZ,Soar Valley                     ,1569,979,10,48,590
38PNGA,South Keyworth                  ,4472,2807,35,147,1665
38PNGB,Stanford                        ,1156,741,5,20,415
38PNGC,Thoroton                        ,1316,830,10,22,486
38PNGD,Tollerton                       ,1520,911,2,30,609
38PNGE,Wiverton                        ,1530,1013,9,46,517
38PNGF,Wolds                           ,952,567,1,17,385
38PNSS,Shipping                        ,0,0,0,0,0
39PPFA,Adderbury                       ,1942,1143,8,40,799
39PPFB,Ambrosden                       ,2192,1674,10,73,518
39PPFC,Ardley                          ,2202,1534,54,34,668
39PPFD,Bicester East                   ,6215,4732,62,262,1483
39PPFE,Bicester South                  ,3404,2142,20,147,1262
39PPFF,Bicester West                   ,5979,4567,44,218,1412
39PPFG,Bloxham                         ,3112,2060,14,125,1052
39PPFH,Bodicote                        ,1725,1100,7,47,625
39PPFJ,Calthorpe                       ,5207,3797,48,308,1410
39PPFK,Chesterton                      ,966,666,7,27,300
39PPFL,Cropredy                        ,1643,1042,6,62,601
39PPFM,Deddington                      ,1870,1173,10,62,697
39PPFN,Easington                       ,4833,3011,16,181,1822
39PPFP,Fringford                       ,1327,884,5,29,443
39PPFQ,Gosford                         ,1069,726,3,22,343
39PPFR,Grimsbury                       ,5060,3535,27,319,1525
39PPFS,Hardwick                        ,5621,4308,26,282,1313
39PPFT,Heyford                         ,2791,2070,121,45,721
39PPFU,Hook Norton                     ,1643,986,3,48,657
39PPFW,Hornton                         ,1208,754,11,29,454
39PPFX,Kirtlington                     ,2078,1320,14,57,758
39PPFY,Launton                         ,1704,1224,12,64,480
39PPFZ,Neithrop                        ,4228,2594,30,327,1634
39PPGA,North West Kidlington           ,6468,4676,25,168,1792
39PPGB,Otmoor                          ,1499,980,6,27,519
39PPGC,Ruscote                         ,4665,2979,32,362,1686
39PPGD,Sibford                         ,1348,833,5,35,515
39PPGE,South East Kidlington           ,4436,3048,9,124,1388
39PPGF,Steeple Aston                   ,1244,808,9,33,436
39PPGG,Wroxton                         ,1726,1059,8,36,667
39PPGH,Yarnton                         ,2843,1918,10,77,925
39PPSS,Shipping                        ,0,0,0,0,0
39PQFA,Blackbird Leys                  ,6295,4421,43,610,1874
39PQFB,Central                         ,1098,472,6,19,626
39PQFC,Cherwell                        ,5443,3049,27,210,2394
39PQFD,East                            ,5521,3436,27,390,2085
39PQFE,Headington                      ,6218,3751,25,347,2467
39PQFF,Iffley                          ,6160,3695,36,304,2465
39PQFG,Littlemore                      ,5656,3478,37,325,2178
39PQFH,Marston                         ,5107,3148,19,207,1959
39PQFJ,North                           ,4416,2516,31,147,1900
39PQFK,old marston and risinghurst     ,5115,3371,11,199,1744
39PQFL,Quarry                          ,5372,3294,20,214,2078
39PQFM,St.Clement's                    ,6132,3673,29,524,2459
39PQFN,South                           ,5565,3287,44,387,2278
39PQFP,Temple Cowley                   ,5367,3628,55,290,1739
39PQFQ,West                            ,4896,3007,19,275,1889
39PQFR,Wolvercote                      ,5550,3154,22,188,2396
39PQFS,Wood Farm                       ,5787,3680,40,275,2107
39PQSS,Shipping                        ,0,0,0,0,0
39PRFA,Aston Rowant                    ,2048,1338,4,53,710
39PRFB,Benson                          ,3779,2662,14,104,1117
39PRFC,Berinsfield                     ,2153,1565,11,176,588
39PRFD,Brightwell                      ,2015,1226,9,62,789
39PRFE,Chalgrove                       ,3382,2423,13,98,959
39PRFF,Chinnor                         ,4558,3332,22,146,1226
39PRFG,Cholsey                         ,3290,2074,15,83,1216
39PRFH,Clifton Hampden                 ,2329,1556,4,101,773
39PRFJ,Crowmarsh                       ,2590,1579,4,73,1011
39PRFK,Didcot North                    ,4648,3374,16,166,1274
39PRFL,Didcot Northbourne              ,3106,2363,11,139,743
39PRFM,Didcot South                    ,4791,3056,18,178,1735
39PRFN,Dorchester                      ,1885,1126,3,51,759
39PRFP,Forest Hill                     ,1717,1118,1,57,599
39PRFQ,Garsington                      ,1871,1299,4,63,572
39PRFR,Goring                          ,3131,1797,8,98,1334
39PRFS,Goring Heath                    ,1874,1144,1,59,730
39PRFT,Great Milton                    ,1899,1277,1,59,622
39PRFU,Hagbourne                       ,2506,1671,7,85,835
39PRFW,Henley                          ,9049,5219,18,256,3830
39PRFX,horspath                        ,1169,798,3,44,371
39PRFY,Kidmore End                     ,1467,939,1,43,528
39PRFZ,Nettlebed                       ,1939,1208,3,56,731
39PRGA,Rotherfield Peppard             ,1663,1036,4,43,627
39PRGB,Shiplake                        ,2046,1206,2,48,840
39PRGC,Sonning Common                  ,3060,1914,9,79,1146
39PRGD,Thame North                     ,4526,3414,8,130,1112
39PRGE,Thame South                     ,4172,2740,17,156,1432
39PRGF,Wallingford                     ,5468,3654,32,184,1814
39PRGG,Watlington                      ,2270,1416,10,69,854
39PRGH,Wheatley                        ,3498,2344,11,109,1154
39PRGJ,Woodcote                        ,1998,1400,3,47,598
39PRSS,Shipping                        ,0,0,0,0,0
39PSFA,Abbey                           ,8498,6414,25,243,2084
39PSFB,Appleton                        ,1239,822,4,33,417
39PSFC,Caldecott                       ,6417,4463,44,287,1954
39PSFD,Craven                          ,1602,1051,9,48,551
39PSFE,Cumnor                          ,4381,2804,14,112,1577
39PSFF,Drayton                         ,1832,1232,11,59,600
39PSFG,Faringdon and Littleworth       ,4328,2885,24,193,1443
39PSFH,Fitzharris                      ,3533,2356,18,149,1177
39PSFJ,Greendown                       ,1974,1319,11,81,655
39PSFK,Grove                           ,5677,4259,29,159,1418
39PSFL,Harwell and Chilton             ,2594,1649,15,80,945
39PSFM,Hendred                         ,1523,954,8,36,569
39PSFN,Hinksey                         ,3868,2386,13,111,1482
39PSFP,Icknield                        ,3867,2327,10,113,1540
39PSFQ,Island Villages                 ,1547,1007,13,41,540
39PSFR,Kennington                      ,3254,2080,11,66,1174
39PSFS,Kingston Bagpuize and Southmoor ,1460,1002,7,47,458
39PSFT,Longworth                       ,1261,831,6,33,430
39PSFU,Marcham                         ,1670,1115,5,37,555
39PSFW,Northcourt                      ,4107,2904,13,110,1203
39PSFX,Ock                             ,1567,1039,2,59,528
39PSFY,Radley                          ,1873,1348,8,73,525
39PSFZ,St.Helen Without                ,1784,1357,41,27,427
39PSGA,Segsbury                        ,3663,2543,35,128,1120
39PSGB,Shrivenham                      ,3013,1976,31,82,1037
39PSGC,Stanford                        ,1578,1062,9,48,516
39PSGD,Steventon                       ,1158,753,3,37,405
39PSGE,Sunningwell and Wooton          ,2788,1744,8,83,1044
39PSGF,Sutton Courtenay                ,2785,1841,12,162,944
39PSGG,The Coxwells                    ,1244,812,5,43,432
39PSGH,Upton and Blewbury              ,1575,966,5,43,609
39PSSS,Shipping                        ,0,0,0,0,0
39PTFA,Ascott and Shipton              ,1462,865,6,46,597
39PTFB,Aston Bampton and Standlake     ,1959,1312,6,72,647
39PTFC,Bampton                         ,1981,1237,8,62,744
39PTFD,Bartons                         ,1494,1023,9,44,471
39PTFE,Bladon and Cassington           ,1234,763,4,35,471
39PTFF,Brize Norton and Curbridge      ,1862,1396,14,67,466
39PTFG,Burford                         ,1546,830,5,42,716
39PTFH,Carterton North                 ,5565,4203,41,192,1362
39PTFJ,Carterton South                 ,4109,3346,32,125,763
39PTFK,Chadlington                     ,1055,638,6,37,417
39PTFL,Charlbury                       ,2135,1327,6,60,808
39PTFM,Chipping Norton                 ,4327,2697,18,162,1630
39PTFN,Clanfield and Shilton           ,1355,879,7,48,476
39PTFP,Combe and Stonesfield           ,1808,1132,2,51,676
39PTFQ,Ducklington                     ,1206,862,6,43,344
39PTFR,Enstone                         ,1248,791,5,56,457
39PTFS,Eynsham                         ,3855,2708,8,138,1147
39PTFT,Filkins and Langford            ,955,567,3,31,388
39PTFU,Finstock and Leafield           ,1247,834,6,44,413
39PTFW,Freeland and Hanborough         ,3241,2167,14,99,1074
39PTFX,Hailey                          ,1506,961,4,35,545
39PTFY,Kingham                         ,1161,689,2,27,472
39PTFZ,Milton-under-Wychwood           ,1605,962,10,36,643
39PTGA,Minster Lovell                  ,1321,860,5,29,461
39PTGB,North Leigh                     ,1514,968,6,55,546
39PTGC,Rollright                       ,1083,661,6,33,422
39PTGD,Stanton Harcourt                ,1369,921,9,49,448
39PTGE,Tackley and Wootton             ,1427,942,8,53,485
39PTGF,Witney East                     ,3801,2632,27,101,1169
39PTGG,Witney North                    ,2545,1765,5,98,780
39PTGH,Witney South                    ,5248,3861,32,170,1387
39PTGJ,Witney West                     ,3288,2086,28,134,1202
39PTGK,Woodstock                       ,2624,1648,9,67,976
39PTSS,Shipping                        ,0,0,0,0,0
40PUFA,Albrighton                      ,3751,2227,28,132,1524
40PUFB,Alveley                         ,2092,1321,12,72,771
40PUFC,Bridgnorth Castle               ,853,534,7,22,319
40PUFD,Bridgnorth East                 ,1288,757,5,54,531
40PUFE,Bridgnorth Morfe                ,3074,2088,20,116,986
40PUFF,Bridgnorth West                 ,4146,2606,32,144,1540
40PUFG,Broseley                        ,3841,2476,44,189,1365
40PUFH,Claverley                       ,1163,703,8,37,460
40PUFJ,Ditton Priors                   ,980,606,3,21,374
40PUFK,Glazeley                        ,1187,734,4,35,453
40PUFL,Harrington                      ,1118,722,7,45,396
40PUFM,Highley                         ,2560,1609,22,112,951
40PUFN,Idsall                          ,2852,1860,22,118,992
40PUFP,Kinlet                          ,1071,663,11,27,408
40PUFQ,Manor                           ,2405,1493,20,65,912
40PUFR,Morville                        ,1085,687,13,37,398
40PUFS,Much Wenlock                    ,2600,1581,11,82,1019
40PUFT,Sheriffhales                    ,2470,1866,17,65,604
40PUFU,Stottesdon                      ,863,556,19,25,307
40PUFW,Worfield                        ,1702,1144,17,60,558
40PUSS,Shipping                        ,0,0,0,0,0
40PWFA,Baschurch                       ,1432,909,10,37,523
40PWFB,Clive                           ,1088,642,8,32,446
40PWFC,Cockshutt                       ,1090,659,11,32,431
40PWFD,Colemere                        ,0,0,0,0,0
40PWFE,Ellesmere Rural West            ,1602,979,10,70,623
40PWFF,Ellesmere Urban                 ,2470,1408,27,100,1062
40PWFG,Hinstock                        ,1796,1107,18,51,689
40PWFH,Hodnet                          ,1142,691,5,35,451
40PWFJ,Market Drayton East             ,2054,1203,19,111,851
40PWFK,Market Drayton North            ,3452,2118,28,106,1334
40PWFL,Market Drayton South            ,2091,1249,18,74,842
40PWFM,Myddle                          ,960,587,3,11,373
40PWFN,Prees                           ,2171,1300,22,67,871
40PWFP,Shavington                      ,1057,642,10,39,415
40PWFQ,Shawbury                        ,1960,1318,21,63,642
40PWFR,Stanton                         ,823,513,6,21,310
40PWFS,Stoke upon Tern                 ,1197,777,13,40,420
40PWFT,Sutton                          ,874,599,13,30,275
40PWFU,Wem Rural                       ,946,597,6,33,349
40PWFW,Wem Urban                       ,4073,2223,25,117,1850
40PWFX,Whitchurch North                ,2375,1495,22,74,880
40PWFY,Whitchurch Rural                ,1185,684,12,14,501
40PWFZ,Whitchurch South                ,2312,1365,24,83,947
40PWGA,Whitchurch West                 ,1684,997,20,74,687
40PWGB,Whixall                         ,1609,1001,20,34,608
40PWGC,Woore                           ,1302,747,9,24,555
40PWSS,Shipping                        ,0,0,0,0,0
40PXFA,Cambrian                        ,4190,2612,25,184,1578
40PXFB,Gatacre                         ,2501,1540,35,145,961
40PXFC,Gobowen                         ,2666,1565,36,119,1101
40PXFD,Kinnerley                       ,940,570,4,22,370
40PXFE,Llanyblodwel                    ,0,0,0,0,0
40PXFF,Llanymynech                     ,1824,1043,9,70,781
40PXFG,Maserfield                      ,2348,1217,18,61,1131
40PXFH,Ruyton-XI-Towns                 ,0,0,0,0,0
40PXFJ,St.Martin's                     ,1985,1183,18,83,802
40PXFK,Sweeney                         ,1619,959,8,61,660
40PXFL,Trefonen                        ,1178,673,10,45,505
40PXFM,Victoria                        ,2481,1518,32,155,963
40PXFN,West Felton                     ,1587,1028,18,55,559
40PXFP,Weston Rhyn                     ,1820,1073,9,88,747
40PXFQ,Whittington                     ,1819,1101,21,81,718
40PXSS,Shipping                        ,0,0,0,0,0
40PYFA,Attingham                       ,1102,680,13,45,422
40PYFB,Bagley                          ,3783,2539,36,109,1244
40PYFC,Bayston Hill                    ,4372,2844,34,100,1528
40PYFD,Belle-Vue                       ,4375,2625,44,165,1750
40PYFE,Castlefields and Ditherington   ,4438,2773,42,291,1665
40PYFF,Condover                        ,1551,889,4,53,662
40PYFG,Copthorne                       ,6545,3848,46,191,2697
40PYFH,Harlescott                      ,4226,2767,73,264,1459
40PYFJ,Haughmond                       ,1952,1304,14,45,648
40PYFK,Lawley                          ,1772,991,12,47,781
40PYFL,Meole-Brace                     ,6003,3856,43,205,2147
40PYFM,Monkmoor                        ,5118,3080,49,196,2038
40PYFN,Montford                        ,1362,818,22,34,544
40PYFP,Onslow                          ,1139,714,11,37,425
40PYFQ,Pimhill                         ,1409,835,3,45,574
40PYFR,Quarry                          ,3707,2130,22,124,1577
40PYFS,Rea Valley                      ,5366,3229,44,142,2137
40PYFT,Rowton                          ,1555,983,14,53,572
40PYFU,Severn Valley                   ,1774,1085,15,75,689
40PYFW,Sundorne                        ,3987,2464,53,185,1523
40PYFX,Sutton                          ,4113,2569,34,122,1544
40PYFY,Underdale                       ,4161,2475,43,221,1686
40PYSS,Shipping                        ,0,0,0,0,0
40PZFA,Apedale                         ,0,0,0,0,0
40PZFB,Ashford                         ,0,0,0,0,0
40PZFC,Bishop's Castle                 ,1620,934,10,65,686
40PZFD,Bitterley                       ,0,0,0,0,0
40PZFE,Bucknell                        ,0,0,0,0,0
40PZFF,Burford                         ,968,610,6,27,358
40PZFG,Caynham                         ,1434,800,16,29,634
40PZFH,Chirbury                        ,0,0,0,0,0
40PZFJ,Church Stretton North           ,1791,752,5,41,1039
40PZFK,Church Stretton South           ,2478,1217,28,61,1261
40PZFL,Clee                            ,1276,779,15,47,497
40PZFM,Cleobury Mortimer               ,1962,1282,16,64,680
40PZFN,Clun                            ,0,0,0,0,0
40PZFP,Clunbury                        ,1375,743,16,47,632
40PZFQ,Diddlebury                      ,0,0,0,0,0
40PZFR,Hopton Wafers                   ,0,0,0,0,0
40PZFS,Ludlow Castle                   ,2412,1293,35,105,1119
40PZFT,Ludlow East Hamlet              ,2955,1790,37,122,1165
40PZFU,Ludlow Galdeford                ,2317,1293,28,141,1024
40PZFW,Lydbury North                   ,1460,846,15,54,614
40PZFX,Munslow                         ,1304,786,10,42,518
40PZFY,Newcastle                       ,1464,798,18,46,666
40PZFZ,Stanton Lacy                    ,1251,789,18,50,462
40PZGA,Stoke St.Milborough             ,1323,793,14,61,530
40PZGB,Stokesay                        ,1833,1069,18,71,764
40PZGC,Wentnor                         ,0,0,0,0,0
40PZGD,Wistanstow                      ,0,0,0,0,0
40PZGE,Worthen                         ,2276,1389,12,56,887
40PZSS,SHIPPING                        ,0,0,0,0,0
40QAFA,Arleston                        ,1975,1101,18,165,874
40QAFB,Brookside                       ,4268,3160,64,417,1108
40QAFC,Church Aston                    ,1438,910,10,54,528
40QAFD,College                         ,2090,1198,19,146,892
40QAFE,Cuckoo Oak                      ,4159,2885,51,373,1274
40QAFF,Dawley Magna                    ,5945,3962,55,325,1983
40QAFG,Donnington                      ,3552,1894,45,204,1658
40QAFH,Donnington Wood                 ,2193,1452,23,189,741
40QAFJ,Dothill and Park                ,5944,4060,52,250,1884
40QAFK,Edgmond                         ,2208,1396,18,40,812
40QAFL,Ercall                          ,2047,1158,9,52,889
40QAFM,Ercall Magna                    ,2662,1671,16,87,991
40QAFN,Hadley                          ,3826,2301,43,281,1525
40QAFP,Haygate                         ,2232,1219,18,124,1013
40QAFQ,Hollinswood/Randlay             ,4771,3418,55,282,1353
40QAFR,Ironbridge(The Gorge)           ,2192,1491,9,108,701
40QAFS,Ketley                          ,2454,1614,24,125,840
40QAFT,Ketley Bank                     ,2056,1337,11,100,719
40QAFU,Langley                         ,2509,1527,41,238,982
40QAFW,Lawley                          ,2940,2115,36,173,825
40QAFX,Leegomery                       ,3972,2609,42,230,1363
40QAFY,Lilleshall                      ,2486,1603,16,75,883
40QAFZ,Madeley                         ,4384,2654,31,230,1730
40QAGA,Malinslee                       ,3621,2209,40,283,1412
40QAGB,Newport East                    ,2345,1468,20,88,877
40QAGC,Newport North                   ,2673,1679,18,81,994
40QAGD,Newport West                    ,2621,1648,16,88,973
40QAGE,Priorslee                       ,5274,3498,31,199,1776
40QAGF,Stirchley                       ,3195,2253,46,216,942
40QAGG,Wombridge                       ,4550,2929,45,189,1621
40QAGH,Woodside                        ,4909,3285,60,594,1624
40QAGJ,Wrockwardine                    ,2248,1526,19,74,722
40QAGK,Wrockwardine Wood               ,3907,2512,48,172,1395
40QASS,Shipping                        ,0,0,0,0,0
41QBFA,Ashwick                         ,1264,785,2,54,479
41QBFB,Avalon                          ,1994,1192,12,61,802
41QBFC,Beacon                          ,1568,1037,8,69,531
41QBFD,Beckington and Rode             ,1803,1074,5,82,729
41QBFE,Chilcompton and Ston Easton     ,1853,1190,5,70,663
41QBFF,Coleford                        ,1737,1089,9,70,648
41QBFG,Creech                          ,2135,1306,5,45,829
41QBFH,Ebbor                           ,1344,888,8,46,456
41QBFJ,Frome Badcox                    ,4736,3003,19,248,1733
41QBFK,Frome Fromefield                ,6159,4106,29,252,2053
41QBFL,Frome Keyford                   ,3363,2232,30,250,1131
41QBFM,Frome Welshmill                 ,3804,2410,36,219,1394
41QBFN,Glastonbury St.Benedict's       ,1416,876,4,78,540
41QBFP,Glastonbury St.Edmund's         ,1394,894,10,79,500
41QBFQ,Glastonbury St.John's           ,1353,823,9,44,530
41QBFR,Glastonbury St.Mary's           ,2040,1239,16,88,801
41QBFS,Mells                           ,1889,1175,6,92,714
41QBFT,Moor                            ,1918,1262,7,64,656
41QBFU,Nedge                           ,1258,796,8,21,462
41QBFW,Nordinton                       ,1552,959,7,48,593
41QBFX,Postlebury                      ,1642,1049,7,75,593
41QBFY,Pylcombe                        ,1402,828,11,39,574
41QBFZ,Rodney                          ,1551,923,3,54,628
41QBGA,Sheppey                         ,1872,1096,13,64,776
41QBGB,Shepton Mallet                  ,6041,3916,47,308,2125
41QBGC,Stratton                        ,1944,1178,10,68,766
41QBGD,Street North                    ,3561,2151,19,155,1410
41QBGE,Street South                    ,4041,2554,20,157,1487
41QBGF,Vale                            ,1540,907,6,57,633
41QBGG,Wells Central                   ,1686,887,6,39,799
41QBGH,Wells St.Cuthbert's             ,3522,2027,21,138,1495
41QBGJ,Wells St.Thomas                 ,2937,1526,9,108,1411
41QBSS,Shipping                        ,0,0,0,0,0
41QCFA,Axbridge                        ,1361,832,3,77,529
41QCFB,Axe Vale                        ,1683,969,8,57,714
41QCFC,Berrow                          ,2484,1354,11,101,1130
41QCFD,Brent                           ,1835,1067,12,57,768
41QCFE,Burnham North                   ,4212,1795,11,110,2417
41QCFF,Burnham South                   ,5060,2654,24,267,2406
41QCFG,Cannington and Combwich         ,2325,1340,24,99,985
41QCFH,Central                         ,4540,2922,39,260,1618
41QCFJ,Cheddar                         ,3668,2120,19,102,1548
41QCFK,Dowsborough                     ,1548,876,9,48,672
41QCFL,Eastover                        ,2414,1571,26,161,843
41QCFM,Eastern Quantocks               ,1261,726,3,24,535
41QCFN,East Poldens                    ,1537,949,2,58,588
41QCFP,Hamp                            ,4065,2528,57,368,1537
41QCFQ,Highbridge                      ,4699,2615,45,229,2084
41QCFR,Huntspill                       ,2054,1226,17,89,828
41QCFS,Mark                            ,1337,748,8,35,589
41QCFT,Newton Green                    ,1243,783,6,40,460
41QCFU,North Petherton                 ,3002,1743,27,111,1259
41QCFW,Parchey                         ,1224,765,12,54,459
41QCFX,Pawlett and Puriton             ,2251,1387,20,87,864
41QCFY,Quantock                        ,4165,2381,27,149,1784
41QCFZ,Sandford                        ,1648,970,8,69,678
41QCGA,Sowey                           ,933,555,11,45,378
41QCGB,Shipham                         ,898,512,1,25,386
41QCGC,Sydenham                        ,7100,4779,88,481,2321
41QCGD,Victoria                        ,3050,1770,40,198,1280
41QCGE,Wedmore                         ,2352,1305,5,48,1047
41QCGF,Westonzoyland                   ,1397,919,18,63,478
41QCGG,West Poldens                    ,1908,1089,14,52,819
41QCGH,Woolavington                    ,1627,902,18,82,725
41QCSS,Shipping                        ,0,0,0,0,0
41QDFA,Blackdown                       ,1860,995,9,49,865
41QDFB,Blackmoor Vale                  ,3553,2092,16,148,1461
41QDFC,Brue                            ,2268,1405,13,69,863
41QDFD,Burrow Hill                     ,1582,925,12,57,657
41QDFE,Camelot                         ,1816,984,11,69,832
41QDFF,Cary                            ,3534,2000,27,99,1534
41QDFG,Chard North East                ,1945,1197,15,105,748
41QDFH,Chard North West                ,3207,1875,17,116,1332
41QDFJ,Chard Parish                    ,1914,1128,6,59,786
41QDFK,Chard South East                ,2135,1217,8,69,918
41QDFL,Chard South West                ,1363,702,4,73,661
41QDFM,Chinnock                        ,1639,898,8,38,741
41QDFN,Coker                           ,4033,2411,30,146,1622
41QDFP,Crewkerne Town                  ,5264,3157,27,222,2107
41QDFQ,Curry Rivel                     ,2302,1243,11,87,1059
41QDFR,Dowlish                         ,1487,821,9,51,666
41QDFS,Egwood                          ,1763,1046,6,61,717
41QDFT,Hazelbury                       ,1218,674,8,47,544
41QDFU,Houndstone                      ,8683,5928,75,328,2755
41QDFW,Ilminster Town                  ,3470,2067,8,124,1403
41QDFX,Islemoor                        ,1235,698,4,58,537
41QDFY,Ivelchester                     ,2085,1588,39,71,497
41QDFZ,Langport and Huish              ,2326,1248,21,81,1078
41QDGA,Lynches                         ,1482,805,3,52,677
41QDGB,Martock                         ,3964,2393,30,150,1571
41QDGC,Milborne Port                   ,2044,1183,10,61,861
41QDGD,Mudford                         ,1409,758,11,33,651
41QDGE,Neroche                         ,1843,952,6,52,891
41QDGF,Northstone                      ,2313,1324,9,64,989
41QDGG,St.Michael's                    ,1764,1048,3,65,716
41QDGH,South Petherton                 ,2584,1319,16,94,1265
41QDGJ,Stoke                           ,1483,918,8,46,565
41QDGK,Turn Hill                       ,1868,1088,12,65,780
41QDGL,Wessex                          ,4157,2452,20,153,1705
41QDGM,Wincanton                       ,4520,2644,30,146,1876
41QDGN,Windwhistle                     ,1712,992,7,55,720
41QDGP,Yeovil Central                  ,3184,2095,40,225,1089
41QDGQ,Yeovil East                     ,4640,3017,44,283,1623
41QDGR,Yeovil North                    ,3198,2009,29,190,1189
41QDGS,Yeovil Preston                  ,3678,2278,40,169,1400
41QDGT,Yeovil South                    ,3959,2471,24,141,1488
41QDGU,Yeovil West                     ,4039,2417,50,191,1622
41QDSS,Shipping                        ,0,0,0,0,0
41QEFA,Bishop's Hull                   ,2739,1492,19,107,1247
41QEFB,Bishop's Lydeard                ,2360,1295,17,51,1065
41QEFC,Blackdown                       ,1478,861,12,54,617
41QEFD,Bradford-on-Tone                ,1291,777,1,43,514
41QEFE,Comeytrowe                      ,4421,2762,31,94,1659
41QEFF,Milverton                       ,1235,649,9,40,586
41QEFG,Monument                        ,1510,924,9,50,586
41QEFH,Neroche                         ,1648,928,3,37,720
41QEFJ,North Curry                     ,1302,728,7,61,574
41QEFK,North Deane                     ,1116,640,7,34,476
41QEFL,Norton Fitzwarren               ,1730,1211,22,63,519
41QEFM,Ruishton and Creech             ,3107,1789,5,57,1318
41QEFN,Staplegrove                     ,2224,1344,19,69,880
41QEFP,Stoke St.Gregory                ,1089,671,13,36,418
41QEFQ,Taunton Fairwater               ,4383,2753,27,216,1630
41QEFR,Taunton Halcon                  ,4147,2472,50,363,1675
41QEFS,Taunton Holway                  ,4244,3110,33,199,1134
41QEFT,Taunton Lyngford                ,4042,2470,35,233,1572
41QEFU,Taunton Manor                   ,2382,1291,9,108,1091
41QEFW,Taunton Priory and Wilton       ,4223,2435,27,225,1788
41QEFX,Taunton Pyrland                 ,2580,1595,28,121,985
41QEFY,Taunton Rowbarton               ,2744,1597,23,158,1147
41QEFZ,Taunton Trinity                 ,4671,2916,45,190,1755
41QEGA,Trull                           ,1448,729,3,36,719
41QEGB,Wellington North                ,3586,2178,30,136,1408
41QEGC,Wellington Rockwell Green       ,1307,813,3,63,494
41QEGD,Wellington South                ,4227,2342,23,126,1885
41QEGE,West Deane                      ,1087,646,6,20,441
41QEGF,West Monkton                    ,1595,908,9,56,687
41QEGG,Wiveliscombe                    ,1934,1096,7,88,838
41QESS,Shipping                        ,0,0,0,0,0
41QFFA,Alcombe                         ,2916,1620,16,97,1296
41QFFB,Aville Vale                     ,0,0,0,0,0
41QFFC,Carhampton and Withycombe       ,1715,830,9,66,885
41QFFD,Crowcombe and Stogumber         ,1443,801,5,48,642
41QFFE,Dulverton and Brushford         ,2317,1198,6,72,1119
41QFFF,Dunster                         ,0,0,0,0,0
41QFFG,East Brendon                    ,0,0,0,0,0
41QFFH,Exmoor                          ,0,0,0,0,0
41QFFJ,Haddon                          ,0,0,0,0,0
41QFFK,Holnicote                       ,1151,581,7,40,570
41QFFL,Minehead North                  ,2547,1198,12,142,1349
41QFFM,Minehead South                  ,3150,1346,6,109,1804
41QFFN,Old Cleeve                      ,1576,782,5,57,794
41QFFP,Porlock And Oare                ,1251,542,2,39,709
41QFFQ,Quantock Vale                   ,1619,922,11,61,697
41QFFR,Quarme                          ,1340,834,8,48,506
41QFFS,Watchet                         ,2664,1536,25,131,1128
41QFFT,West Quantock                   ,981,441,3,23,540
41QFFU,Williton                        ,1940,1048,14,99,892
41QFSS,Shipping                        ,0,0,0,0,0
42QGFA,Anglesey                        ,5971,4045,64,246,1926
42QGFB,Brereton and Ravenhill          ,5150,3179,62,345,1971
42QGFC,Brindley Heath                  ,0,0,0,0,0
42QGFD,Broomhill                       ,4691,2630,75,384,2061
42QGFE,Cannock South                   ,4761,2816,54,394,1945
42QGFF,Chadsmoor                       ,4708,2829,71,346,1879
42QGFG,Etching Hill                    ,5326,3769,78,326,1557
42QGFH,Hagley                          ,3798,2301,56,306,1497
42QGFJ,Heath Hayes                     ,7087,5192,73,288,1895
42QGFK,Longford                        ,4603,2709,36,156,1894
42QGFL,Norton Canes                    ,5175,3486,54,269,1689
42QGFM,Parkside                        ,4429,2570,79,192,1859
42QGFN,Pye Green Valley                ,6138,4136,79,369,2002
42QGFP,Rawnsley                        ,3370,2227,33,184,1143
42QGFQ,Western Springs                 ,4711,3057,46,221,1654
42QGSS,Shipping                        ,0,0,0,0,0
42QHFA,Abbey                           ,1944,1217,17,47,727
42QHFB,Bagots                          ,2061,1336,5,48,725
42QHFC,Branston                        ,3217,2031,14,98,1186
42QHFD,Broadway                        ,2940,1829,37,216,1111
42QHFE,Burton                          ,1111,754,11,96,357
42QHFF,Churnet                         ,1899,1260,12,70,639
42QHFG,Crown                           ,1994,1309,16,55,685
42QHFH,Edgehill                        ,3076,1840,28,171,1236
42QHFJ,Eton                            ,3045,1844,55,222,1201
42QHFK,Heath                           ,4578,2940,42,225,1638
42QHFL,Horninglow                      ,4753,2873,43,258,1880
42QHFM,Needwood                        ,3998,2556,26,128,1442
42QHFN,Outwoods                        ,2112,1277,16,67,835
42QHFP,Rolleston                       ,2656,1644,18,70,1012
42QHFQ,Shobnall                        ,3315,2014,40,162,1301
42QHFR,Stapenhill                      ,4720,3104,25,158,1616
42QHFS,Stretton                        ,5928,4075,45,152,1853
42QHFT,Town                            ,3579,2144,28,155,1435
42QHFU,Tutbury and Hanbury             ,3086,1942,22,103,1144
42QHFW,Uxbridge                        ,2065,1266,42,180,799
42QHFX,Victoria                        ,3462,2042,51,296,1420
42QHFY,Waterside                       ,3345,1987,56,285,1358
42QHFZ,Weaver                          ,1627,987,6,35,640
42QHGA,Winshill                        ,5145,2974,58,304,2171
42QHGB,Yoxall                          ,1654,1043,8,51,611
42QHSS,Shipping                        ,0,0,0,0,0
42QJFA,All Saints                      ,1636,1073,15,64,563
42QJFB,Alrewas                         ,3541,2422,24,121,1119
42QJFC,Armitage with Handsacre         ,3637,2321,29,222,1316
42QJFD,Boney Hay                       ,2490,1658,35,161,832
42QJFE,Bourne Vale                     ,1506,951,17,57,555
42QJFF,Central                         ,4451,2919,33,169,1532
42QJFG,Chadsmead                       ,2651,1676,33,196,975
42QJFH,Chase Terrace                   ,3295,2237,23,135,1058
42QJFJ,Chasetown                       ,3308,1944,43,222,1364
42QJFK,Colton and Ridwares             ,1614,1056,8,31,558
42QJFL,Curborough                      ,4403,2954,48,271,1449
42QJFM,Fazeley                         ,3683,2232,32,174,1451
42QJFN,Hammerwich                      ,3437,2365,31,119,1072
42QJFP,Highfield                       ,4242,2900,33,117,1342
42QJFQ,King's Bromley                  ,1274,803,2,38,471
42QJFR,Leomansley                      ,2485,1570,10,66,915
42QJFS,Little Aston                    ,2133,1336,1,41,797
42QJFT,Longdon                         ,1299,813,10,31,486
42QJFU,Mease Valley                    ,1392,847,6,44,545
42QJFW,Redslade                        ,2884,2091,35,98,793
42QJFX,St.John's                       ,5156,3332,34,135,1824
42QJFY,Shenstone                       ,2708,1707,13,87,1001
42QJFZ,Stonnall                        ,1301,879,10,36,422
42QJGA,Stowe                           ,3477,2301,22,150,1176
42QJGB,Summerfield                     ,2354,1734,20,110,620
42QJGC,Tame                            ,1248,816,7,44,432
42QJGD,Whittington                     ,2664,1837,11,66,827
42QJSS,SHIPPING                        ,0,0,0,0,0
42QKFA,Audley and Bignall End          ,5106,2999,37,180,2107
42QKFB,Bradwell                        ,5062,2985,47,194,2077
42QKFC,Butt Lane                       ,4513,2686,35,243,1827
42QKFD,Chesterton                      ,5492,3334,53,374,2158
42QKFE,Clayton                         ,3515,2032,24,129,1483
42QKFF,Cross Heath                     ,5053,2757,63,410,2296
42QKFG,Halmerend                       ,2829,1675,21,90,1154
42QKFH,Holditch                        ,3224,1960,40,201,1264
42QKFJ,Keele                           ,1892,928,18,98,964
42QKFK,Kidsgrove                       ,5911,3945,46,301,1966
42QKFL,Loggerheads                     ,3450,2147,25,94,1303
42QKFM,Madeley                         ,3103,1807,17,95,1296
42QKFN,May Bank                        ,4617,2958,25,135,1659
42QKFP,Newchapel                       ,5242,3661,53,239,1581
42QKFQ,Porthill                        ,3594,2290,31,118,1304
42QKFR,Seabridge                       ,6423,4251,53,208,2172
42QKFS,Silverdale                      ,5635,3316,80,346,2319
42QKFT,Talke                           ,3633,2374,42,162,1259
42QKFU,Thistleberry                    ,4877,2652,35,196,2225
42QKFW,Town                            ,3704,2025,33,225,1679
42QKFX,Westlands                       ,3350,1913,23,109,1437
42QKFY,Whitmore                        ,1798,1090,6,42,708
42QKFZ,Wolstanton                      ,4009,2545,46,213,1464
42QKSS,Shipping                        ,0,0,0,0,0
42QLFA,Acton Trussell                  ,1378,879,14,23,499
42QLFB,Bilbrook                        ,3989,2394,43,198,1595
42QLFC,Bishopswood                     ,1119,770,11,29,349
42QLFD,Brewood                         ,2463,1507,13,73,956
42QLFE,Cheslyn Hay North               ,2579,1776,31,110,803
42QLFF,Cheslyn Hay South               ,2850,2116,32,106,734
42QLFG,Codsall North                   ,3513,2121,23,104,1392
42QLFH,Codsall South                   ,2965,1804,11,69,1161
42QLFJ,Coven                           ,2859,1878,22,133,981
42QLFK,Essington                       ,3765,2494,22,158,1271
42QLFL,Featherstone                    ,3318,2332,37,206,986
42QLFM,Great Wyrley Landywood          ,3619,2567,41,176,1052
42QLFN,Great Wyrley North              ,976,701,8,36,275
42QLFP,Great Wyrley Town               ,4205,2775,39,223,1430
42QLFQ,Huntington                      ,2251,1410,24,218,841
42QLFR,Kinver                          ,4219,2597,23,139,1622
42QLFS,Lapley                          ,2164,1436,18,69,728
42QLFT,Lower Penn                      ,1376,857,9,33,519
42QLFU,Pattingham                      ,1836,1200,9,45,636
42QLFW,Penkridge North East            ,1769,1118,10,65,651
42QLFX,Penkridge South East            ,3605,2561,38,169,1044
42QLFY,Penkridge West                  ,1365,960,7,53,405
42QLFZ,Perton Central                  ,4255,3298,25,156,957
42QLGA,Perton Dippons                  ,4225,3073,37,138,1152
42QLGB,Shareshill                      ,1645,1048,9,37,597
42QLGC,Stourton                        ,1424,853,8,26,571
42QLGD,Swindon                         ,1974,1265,19,93,709
42QLGE,Trysull and Seisdon             ,1697,1055,12,45,642
42QLGF,Wombourne North                 ,3911,2403,31,123,1508
42QLGG,Wombourne South East            ,2797,1785,24,103,1012
42QLGH,Wombourne South West            ,4483,3172,30,242,1311
42QLSS,Shipping                        ,0,0,0,0,0
42QMFA,Barlaston                       ,2454,1394,12,73,1060
42QMFB,Baswich                         ,3235,2034,18,62,1201
42QMFC,Beaconside                      ,2122,1636,22,64,486
42QMFD,Castle                          ,2791,2001,21,82,790
42QMFE,Chartley                        ,2012,1364,18,56,648
42QMFF,Church Eaton                    ,1314,858,14,48,456
42QMFG,Common                          ,2694,1580,36,165,1114
42QMFH,Coton                           ,3524,2328,27,164,1196
42QMFJ,Eccleshall                      ,4784,2885,29,132,1899
42QMFK,Forebridge                      ,2219,1336,21,107,883
42QMFL,Fulford                         ,5298,3106,43,150,2192
42QMFM,Gnosall                         ,4323,2857,34,108,1466
42QMFN,Haywood                         ,3729,2548,23,116,1181
42QMFP,Highfields                      ,2626,1666,55,191,960
42QMFQ,Holmcroft                       ,4272,2793,54,190,1479
42QMFR,Littleworth                     ,4113,2621,36,141,1492
42QMFS,Manor                           ,5092,3057,45,240,2035
42QMFT,Milford                         ,2823,1693,8,69,1130
42QMFU,Milwich                         ,1150,727,14,19,423
42QMFW,Oulton                          ,1361,799,7,35,562
42QMFX,Penkside                        ,3208,2022,55,195,1186
42QMFY,Rowley                          ,3031,1787,23,108,1244
42QMFZ,St.Michael's                    ,2882,1847,15,107,1035
42QMGA,Seighford                       ,3198,2018,21,80,1180
42QMGB,Stonefield and Christchurch     ,2655,1590,10,90,1065
42QMGC,Swynnerton                      ,3397,2109,16,102,1288
42QMGD,Tillington                      ,3209,2150,25,117,1059
42QMGE,Walton                          ,4707,3129,23,154,1578
42QMGF,Weeping Cross                   ,5339,3786,33,119,1553
42QMGG,Woodseaves                      ,1619,1074,29,48,545
42QMSS,Shipping                        ,0,0,0,0,0
42QNFA,Alton                           ,1496,931,5,39,565
42QNFB,Biddulph East                   ,3046,1574,26,233,1472
42QNFC,Biddulph Moor                   ,1706,1169,17,61,537
42QNFD,Biddulph North                  ,4340,2823,26,129,1517
42QNFE,Biddulph South                  ,3651,2307,30,124,1344
42QNFF,Biddulph West                   ,2644,1723,36,108,921
42QNFG,Brown Edge                      ,2159,1348,19,78,811
42QNFH,Caverswall                      ,1299,848,13,47,451
42QNFJ,Cheadle North East              ,2530,1531,23,95,999
42QNFK,Cheadle South East              ,3153,1889,22,109,1264
42QNFL,Cheadle West                    ,3429,2038,27,118,1391
42QNFM,Checkley                        ,4303,2944,37,121,1359
42QNFN,Cheddleton                      ,3392,2121,16,84,1271
42QNFP,Endon and Stanley               ,3561,2175,18,94,1386
42QNFQ,Forsbrook                       ,4440,2967,45,162,1473
42QNFR,Horton                          ,1458,970,5,34,488
42QNFS,Ipstones                        ,1169,715,4,30,454
42QNFT,Kingsley                        ,2479,1504,15,77,975
42QNFU,Leekfrith                       ,1200,788,7,28,412
42QNFW,Leek North East                 ,3650,2105,40,198,1545
42QNFX,Leek North West                 ,3941,2540,22,98,1401
42QNFY,Leek South East                 ,3904,2258,30,114,1646
42QNFZ,Leek South West                 ,4659,2886,29,197,1773
42QNGA,Longnor                         ,1296,830,7,37,466
42QNGB,Warslow                         ,1084,657,4,22,427
42QNGC,Waterhouses                     ,956,621,5,13,335
42QNGD,Werrington                      ,4861,3377,45,135,1484
42QNGE,Wetley Rocks                    ,1636,1091,9,38,545
42QNSS,Shipping                        ,0,0,0,0,0
42QPFA,Abbey                           ,10005,5736,133,620,4269
42QPFB,Berryhill                       ,9402,5618,94,466,3784
42QPFC,Blurton                         ,8506,4419,99,460,4087
42QPFD,Brookhouse                      ,8257,4556,127,794,3701
42QPFE,Burslem Central                 ,9420,5505,106,568,3915
42QPFF,Burslem Grange                  ,8395,4995,113,606,3400
42QPFG,Chell                           ,10163,6060,156,678,4103
42QPFH,East Valley                     ,9877,5701,88,450,4176
42QPFJ,Fenton Green                    ,10397,6611,117,541,3786
42QPFK,Great Fenton                    ,8937,5188,101,539,3749
42QPFL,Hanley Green                    ,9751,6162,91,518,3589
42QPFM,Hartshill                       ,9172,5702,91,483,3470
42QPFN,Longton South                   ,10006,5982,111,594,4024
42QPFP,Meir Park                       ,11025,6569,127,734,4456
42QPFQ,Norton and Bradeley             ,9839,6180,109,567,3659
42QPFR,Shelton                         ,9381,5236,133,741,4145
42QPFS,Stoke West                      ,9249,5522,98,532,3727
42QPFT,Trentham Park                   ,12488,8108,90,427,4380
42QPFU,Tunstall North                  ,8946,5112,95,560,3834
42QPFW,Weston                          ,11711,7905,122,500,3806
42QPSS,Shipping                        ,0,0,0,0,0
42QQFA,Amington                        ,5749,3935,96,409,1814
42QQFB,Belgrave                        ,5771,4021,96,465,1750
42QQFC,Bolehall                        ,5123,3356,77,325,1767
42QQFD,Castle                          ,4449,2534,45,254,1915
42QQFE,Glascote                        ,5708,3818,122,566,1890
42QQFF,Mercian                         ,5140,3582,58,289,1558
42QQFG,Spital                          ,4880,2865,35,218,2015
42QQFH,Stonydelph                      ,5311,3874,66,400,1437
42QQFJ,Trinity                         ,5144,3680,60,243,1464
42QQFK,Wilnecote                       ,5449,3898,50,343,1551
42QQSS,Shipping                        ,0,0,0,0,0
43QRFA,Alton                           ,1084,625,2,26,459
43QRFB,Berners                         ,1160,611,4,34,549
43QRFC,Bildeston                       ,1325,791,7,52,534
43QRFD,Boxford                         ,1491,875,6,50,616
43QRFE,Brantham                        ,1796,1112,6,46,684
43QRFF,Brett Vale                      ,1194,659,2,36,535
43QRFG,Brookvale                       ,1906,1201,7,66,705
43QRFH,Bures St.Mary                   ,1332,769,4,44,563
43QRFJ,Capel and Wenham                ,2588,1749,11,51,839
43QRFK,Chadacre                        ,1817,1059,8,61,758
43QRFL,Copdock                         ,3431,2458,22,114,973
43QRFM,Dodnash                         ,2812,1615,11,68,1197
43QRFN,Elmsett                         ,1414,857,4,38,557
43QRFP,Glemsford                       ,2516,1693,11,90,823
43QRFQ,Great Cornard North             ,3102,2020,25,176,1082
43QRFR,Great Cornard South             ,3199,2349,10,97,850
43QRFS,Hadleigh                        ,5215,3196,21,162,2019
43QRFT,Holbrook                        ,1479,893,6,25,586
43QRFU,Lavenham                        ,1413,763,5,42,650
43QRFW,Leavenheath                     ,1768,1091,7,56,677
43QRFX,Long Melford                    ,2951,1643,13,118,1308
43QRFY,Nayland                         ,988,539,5,42,449
43QRFZ,North Cosford                   ,1262,810,9,60,452
43QRGA,Polstead And Layham             ,1146,681,1,31,465
43QRGB,Shotley                         ,1932,1341,10,65,591
43QRGC,Sudbury East                    ,2884,1682,16,124,1202
43QRGD,Sudbury North                   ,3202,2018,11,152,1184
43QRGE,Sudbury South                   ,3107,1777,15,157,1330
43QRGF,Waldingfield                    ,2990,1884,17,98,1106
43QRGG,West Samford                    ,1279,759,2,34,520
43QRSS,Shipping                        ,0,0,0,0,0
43QSFA,Brandon East                    ,3681,2060,36,168,1621
43QSFB,Brandon West                    ,2914,1838,32,147,1076
43QSFC,Exning                          ,1563,1006,2,49,557
43QSFD,Granby                          ,2483,1668,8,96,815
43QSFE,Great Heath                     ,2568,1759,23,130,809
43QSFF,Iceni                           ,3656,2645,169,63,1011
43QSFG,Lakenheath                      ,4493,3154,56,117,1339
43QSFH,Manor                           ,1528,969,16,35,559
43QSFJ,Market                          ,3451,2194,39,121,1257
43QSFK,Mill                            ,2039,1496,26,79,543
43QSFL,St.Mary's                       ,3157,1981,14,157,1176
43QSFM,Severals                        ,4330,2980,8,151,1350
43QSFN,South                           ,1288,812,1,42,476
43QSFP,Studlands Park                  ,1857,1378,37,55,479
43QSFQ,The Rows                        ,4187,3115,193,132,1072
43QSSS,Shipping                        ,0,0,0,0,0
43QTFA,Bixley                          ,5905,3375,28,143,2530
43QTFB,Bridge                          ,5698,3642,40,384,2056
43QTFC,Broom Hill                      ,5205,3322,28,187,1883
43QTFD,Castle Hill                     ,5897,3636,38,148,2261
43QTFE,Chantry                         ,4826,2909,35,332,1917
43QTFF,Gainsborough                    ,6108,3638,59,410,2470
43QTFG,Priory Heath                    ,5672,3434,52,347,2238
43QTFH,Rushmere                        ,6023,3533,35,195,2490
43QTFJ,St.Clement's                    ,5911,3868,40,238,2043
43QTFK,St.John's                       ,6371,3948,28,211,2423
43QTFL,St.Margaret's                   ,6058,3663,21,278,2395
43QTFM,Sprites                         ,5734,3669,32,269,2065
43QTFN,Stoke Park                      ,5998,4051,54,349,1947
43QTFP,Town                            ,6107,3923,71,527,2184
43QTFQ,White House                     ,5613,3554,40,339,2059
43QTFR,Whitton                         ,5450,3358,48,350,2092
43QTSS,Shipping                        ,0,0,0,0,0
43QUFA,Badwell Ash                     ,1258,756,5,48,502
43QUFB,Barham                          ,1581,1089,3,44,492
43QUFC,Barking                         ,1489,960,7,63,529
43QUFD,Bramford                        ,2957,1934,17,87,1023
43QUFE,Claydon                         ,1493,947,1,37,546
43QUFF,Creeting                        ,1170,771,7,33,399
43QUFG,Debenham                        ,1678,990,10,48,688
43QUFH,Elmswell                        ,2130,1437,4,50,693
43QUFJ,Eye                             ,1423,824,5,35,599
43QUFK,Fressingfield                   ,1395,791,8,35,604
43QUFL,Gislingham                      ,1649,1030,6,55,619
43QUFM,Haughley and Wetherden          ,1619,996,9,51,623
43QUFN,Helmingham                      ,1193,752,13,33,441
43QUFP,Hoxne                           ,1410,824,2,38,586
43QUFQ,Mendlesham                      ,1541,974,4,43,567
43QUFR,Needham Market                  ,3415,2221,17,97,1194
43QUFS,Norton                          ,1662,1014,6,52,648
43QUFT,Onehouse                        ,1614,982,5,45,632
43QUFU,Palgrave                        ,1458,854,1,53,604
43QUFW,Rattlesden                      ,1450,886,3,46,564
43QUFX,Rickinghall                     ,1842,1086,13,64,756
43QUFY,Ringshall                       ,1943,1392,6,54,551
43QUFZ,Stonham                         ,1217,806,3,30,411
43QUGA,Stowmarket Central              ,3679,2020,14,93,1659
43QUGB,Stowmarket North                ,3400,2138,22,140,1262
43QUGC,Stowmarket South                ,3402,2310,15,117,1092
43QUGD,Stowupland                      ,3364,2153,8,107,1211
43QUGE,Stradbroke                      ,1219,743,5,37,476
43QUGF,Thurston                        ,2048,1367,8,44,681
43QUGG,Walsham-le-Willows              ,1573,960,0,40,613
43QUGH,Wetheringsett                   ,1288,797,7,50,491
43QUGJ,Weybread                        ,1296,760,8,44,536
43QUGK,Woolpit                         ,1319,799,5,39,520
43QUGL,Worlingworth                    ,1316,823,3,33,493
43QUSS,Shipping                        ,0,0,0,0,0
43QWFA,Abbeygate                       ,3008,1768,11,113,1240
43QWFB,Barningham                      ,1836,1131,10,82,705
43QWFC,Barrow                          ,1506,920,0,42,586
43QWFD,Cangle                          ,4355,2943,19,156,1412
43QWFE,Castle                          ,2118,1539,6,113,579
43QWFF,Cavendish                       ,1347,711,4,52,636
43QWFG,Chalkstone                      ,4486,3256,25,216,1230
43QWFH,Chevington                      ,1557,971,4,36,586
43QWFJ,Clare                           ,1601,934,4,43,667
43QWFK,Clements                        ,2648,1819,8,227,829
43QWFL,Eastgate                        ,4120,2808,27,119,1312
43QWFM,Fornham                         ,2091,1397,6,48,694
43QWFN,Great Barton                    ,1704,1033,8,35,671
43QWFP,Honington                       ,1845,1372,25,52,473
43QWFQ,Horringer                       ,1182,722,0,36,460
43QWFR,Horringer Court                 ,1856,1403,15,53,453
43QWFS,Hundon                          ,2095,1157,18,96,938
43QWFT,Ixworth                         ,2085,1317,3,75,768
43QWFU,Kedington                       ,1460,905,8,39,555
43QWFW,Northgate                       ,2415,1435,6,113,980
43QWFX,Pakenham                        ,1677,1114,10,63,563
43QWFY,Risby                           ,1627,1031,5,38,596
43QWFZ,Risbygate                       ,2952,1942,18,97,1010
43QWGA,Rougham                         ,1422,942,7,49,480
43QWGB,St.Mary's and Helions           ,1364,890,7,40,474
43QWGC,St.Olaves                       ,3076,2196,12,172,880
43QWGD,Sextons                         ,2801,1797,5,83,1004
43QWGE,Southgate                       ,3627,2529,24,111,1098
43QWGF,Stanton                         ,2335,1482,8,64,853
43QWGG,Westgate                        ,2803,1642,12,115,1161
43QWGH,Whelnetham                      ,1699,1078,5,57,621
43QWGJ,Wickhambrook                    ,1639,958,5,50,681
43QWGK,Withersfield                    ,1280,809,3,33,471
43QWSS,Shipping                        ,0,0,0,0,0
43QXFA,Aldeburgh                       ,2345,979,6,47,1366
43QXFB,Alderton and Sutton             ,2095,1479,108,51,616
43QXFC,Bealings                        ,1464,825,6,39,639
43QXFD,Bramfield and Cratfield         ,1453,869,7,43,584
43QXFE,Buxlow                          ,1733,928,15,36,805
43QXFF,Dennington                      ,1377,808,9,50,569
43QXFG,Earl Soham                      ,1238,719,3,26,519
43QXFH,Felixstowe Central              ,2688,1378,7,106,1310
43QXFJ,Felixstowe East                 ,3093,1730,6,77,1363
43QXFK,Felixstowe North                ,3030,1768,18,127,1262
43QXFL,Felixstowe South                ,2956,1676,10,137,1280
43QXFM,Felixstowe South East           ,3039,1504,9,83,1535
43QXFN,Felixstowe West                 ,4075,2889,12,153,1186
43QXFP,Framlingham                     ,2198,1283,19,57,915
43QXFQ,Glemham                         ,994,616,11,31,378
43QXFR,Grundisburgh and Witnesham      ,1915,1182,8,46,733
43QXFS,Hasketon                        ,1312,813,2,38,499
43QXFT,Hollesley                       ,1249,702,15,42,547
43QXFU,Kelsale                         ,1095,607,2,36,488
43QXFW,Kesgrave                        ,4270,2628,30,110,1642
43QXFX,Kirton                          ,1670,1052,11,49,618
43QXFY,Leiston                         ,4454,2837,24,136,1617
43QXFZ,Martlesham                      ,3896,2631,16,92,1265
43QXGA,Melton                          ,2746,1606,21,76,1140
43QXGB,Nacton                          ,1971,1295,8,49,676
43QXGC,Orford                          ,964,517,7,28,447
43QXGD,Otley                           ,1070,667,3,41,403
43QXGE,Rushmere                        ,3260,2016,13,63,1244
43QXGF,Saxmundham                      ,1961,1177,28,54,784
43QXGG,Snape                           ,1207,712,8,32,495
43QXGH,Trimleys                        ,4404,3064,14,154,1340
43QXGJ,Tunstall                        ,2507,1848,91,45,659
43QXGK,Ufford                          ,1316,798,11,42,518
43QXGL,Walberswick                     ,1393,643,7,31,750
43QXGM,Westleton                       ,1131,556,2,24,575
43QXGN,Wickham Market                  ,1818,1096,11,50,722
43QXGP,Woodbridge Centre               ,1512,786,19,52,726
43QXGQ,Woodbridge Farlingaye           ,1557,965,13,38,592
43QXGR,Woodbridge Kyson                ,866,524,6,29,342
43QXGS,Woodbridge Riverside            ,1200,520,6,22,680
43QXGT,Woodbridge Seckford             ,1169,646,5,24,523
43QXGU,Yoxford                         ,1223,764,6,33,459
43QXSS,Shipping                        ,0,0,0,0,0
43QYFA,Beccles Town                    ,5751,3149,20,176,2602
43QYFB,Beccles Worlingham              ,3791,2217,18,132,1574
43QYFC,Blything                        ,1711,967,9,46,744
43QYFD,Bungay                          ,3794,2169,23,147,1625
43QYFE,Carlton                         ,6247,3791,39,206,2456
43QYFF,Carlton Colville                ,4034,2583,36,157,1451
43QYFG,Gunton                          ,5401,3016,40,199,2385
43QYFH,Halesworth                      ,3692,1918,16,76,1774
43QYFJ,Harbour                         ,4225,2394,51,330,1831
43QYFK,Kessingland                     ,3645,1887,32,168,1758
43QYFL,Kirkley                         ,4821,2671,58,484,2150
43QYFM,Lothingland                     ,4743,2769,50,162,1974
43QYFN,Mutford                         ,1417,909,6,49,508
43QYFP,Normanston                      ,4581,2611,54,304,1970
43QYFQ,Oulton Broad                    ,5402,3156,43,212,2246
43QYFR,Pakefield                       ,5727,2907,33,217,2820
43QYFS,St.Margarets                    ,5509,3081,52,311,2428
43QYFT,South Elmham                    ,1466,855,6,34,611
43QYFU,Southwold                       ,5073,2317,25,130,2756
43QYFW,Wainford                        ,1333,796,9,48,537
43QYFX,Whitton                         ,4569,2508,39,291,2061
43QYSS,Shipping                        ,0,0,0,0,0
44QZFA,Claygate                        ,5204,3048,12,158,2156
44QZFB,Cobham and Downside             ,4671,2648,11,139,2023
44QZFC,Cobham Fairmile                 ,3349,2009,4,112,1340
44QZFD,Esher                           ,4737,2683,4,156,2054
44QZFE,Hersham North                   ,4397,2829,11,175,1568
44QZFF,Hersham South                   ,5347,3123,9,163,2224
44QZFG,Hinchley Wood                   ,3792,2327,8,93,1465
44QZFH,Long Ditton                     ,3249,2051,11,102,1198
44QZFJ,Molesey East                    ,4623,2952,27,175,1671
44QZFK,Molesey North                   ,4307,2954,16,162,1353
44QZFL,Molesey South                   ,4976,3295,13,208,1681
44QZFM,Oatlands Park                   ,4649,2784,12,161,1865
44QZFN,Oxshott and Stoke D'Abernon     ,4449,2497,10,97,1952
44QZFP,St.George's Hill                ,4051,2365,7,124,1686
44QZFQ,Thames Ditton                   ,4162,2449,10,108,1713
44QZFR,Walton Ambleside                ,2868,1863,19,132,1005
44QZFS,Walton Central                  ,4297,2744,4,154,1553
44QZFT,Walton North                    ,4928,3341,12,216,1587
44QZFU,Walton South                    ,5246,3355,13,159,1891
44QZFW,Weston Green                    ,2688,1647,14,69,1041
44QZFX,Weybridge North                 ,3102,1939,13,137,1163
44QZFY,Weybridge South                 ,3524,2171,10,131,1353
44QZSS,Shipping                        ,0,0,0,0,0
44RAFA,Auriol                          ,3740,2352,14,88,1388
44RAFB,College                         ,4501,2686,17,119,1815
44RAFC,Court                           ,5971,3499,57,266,2472
44RAFD,Cuddington                      ,4399,2743,14,129,1656
44RAFE,Ewell                           ,4189,2342,10,107,1847
44RAFF,Ewell Court                     ,3539,2176,14,95,1363
44RAFG,Nonsuch                         ,3444,2017,14,74,1427
44RAFH,Ruxley                          ,3826,2559,24,177,1267
44RAFJ,Stamford                        ,5180,2782,52,108,2398
44RAFK,Stoneleigh                      ,3631,2291,10,98,1340
44RAFL,Town                            ,4455,2763,22,146,1692
44RAFM,West Ewell                      ,4190,2897,21,125,1293
44RAFN,Woodcote                        ,3912,2438,19,119,1474
44RASS,Shipping                        ,0,0,0,0,0
44RBFA,Ash                             ,7589,5238,20,277,2351
44RBFB,Ash Vale                        ,4839,3529,16,164,1310
44RBFC,Christchurch                    ,3917,2171,8,89,1746
44RBFD,Clandon and Horsley             ,6850,3810,9,137,3040
44RBFE,Effingham                       ,2095,1276,3,49,819
44RBFF,Friary and St.Nicholas          ,6704,4452,23,310,2252
44RBFG,Holy Trinity                    ,4758,2962,27,152,1796
44RBFH,Lovelace                        ,1932,1205,4,58,727
44RBFJ,Merrow and Burpham              ,10400,6993,35,265,3407
44RBFK,Normandy                        ,2419,1522,2,82,897
44RBFL,Onslow                          ,4539,2839,27,126,1700
44RBFM,Pirbright                       ,3013,2390,43,60,623
44RBFN,Send                            ,3205,2075,10,89,1130
44RBFP,Shalford                        ,3150,1867,5,89,1283
44RBFQ,Stoke                           ,5656,3684,28,249,1972
44RBFR,Stoughton                       ,6655,4727,20,206,1928
44RBFS,The Pilgrims                    ,3063,1799,6,66,1264
44RBFT,Tillingbourne                   ,4385,2577,5,149,1808
44RBFU,Tongham                         ,1634,1118,4,52,516
44RBFW,Westborough                     ,6269,4185,19,305,2084
44RBFX,Worplesdon                      ,6587,4375,19,200,2212
44RBSS,Shipping                        ,0,0,0,0,0
44RCFA,Ashtead Common                  ,3252,2002,6,93,1250
44RCFB,Ashtead Park                    ,3078,1719,5,80,1359
44RCFC,Ashtead Village                 ,4686,2652,8,107,2034
44RCFD,Bookham North                   ,3989,2260,6,101,1729
44RCFE,Bookham South                   ,4576,2772,11,101,1804
44RCFF,Box Hill                        ,2698,1740,4,113,958
44RCFG,Brockham                        ,2168,1364,4,49,804
44RCFH,Charlwood                       ,1634,1114,5,64,520
44RCFJ,Dorking North-East              ,1893,1177,2,51,716
44RCFK,Dorking North-West              ,1917,1191,13,46,726
44RCFL,Dorking South-East              ,2885,1720,5,94,1165
44RCFM,Dorking South-West              ,2194,1342,9,66,852
44RCFN,Fetcham East                    ,3498,2195,9,89,1303
44RCFP,Fetcham West                    ,3347,2155,6,70,1192
44RCFQ,Holmwood and Beare Green        ,2218,1386,2,57,832
44RCFR,Leatherhead North               ,4792,3158,18,193,1634
44RCFS,Leatherhead South               ,3335,1748,9,96,1587
44RCFT,Leith Hill                      ,1373,883,5,35,490
44RCFU,North Holmwood                  ,4412,3034,13,165,1378
44RCFW,Okewood                         ,1439,921,5,45,518
44RCFX,Rural East                      ,2006,1192,8,56,814
44RCFY,Rural South                     ,2404,1545,5,80,859
44RCFZ,Westcott                        ,1787,1040,1,61,747
44RCSS,Shipping                        ,0,0,0,0,0
44RDFA,Banstead Village                ,6640,3767,18,172,2873
44RDFB,Chipstead-Hooley and Woodmanster,5101,3217,20,162,1884
44RDFC,Horley East                     ,6969,4983,33,285,1986
44RDFD,Horley West                     ,8435,5946,37,371,2489
44RDFE,Kingswood with Burgh Heath      ,5260,3219,9,135,2041
44RDFF,Nork                            ,5676,3569,18,149,2107
44RDFG,Preston                         ,2413,1408,14,130,1005
44RDFH,Reigate Central                 ,5826,3555,25,216,2271
44RDFJ,Reigate East                    ,5945,3808,40,178,2137
44RDFK,Reigate North                   ,5234,3071,15,135,2163
44RDFL,Reigate North Central           ,4858,3112,20,180,1746
44RDFM,Reigate North East              ,4639,2771,14,235,1868
44RDFN,Reigate South Central           ,5202,3537,20,183,1665
44RDFP,Reigate South East              ,5855,3931,31,254,1924
44RDFQ,Reigate South West              ,4786,2962,12,192,1824
44RDFR,Salfords And Sidlow             ,2505,1661,8,85,844
44RDFS,Tadworth And Walton             ,5180,3161,22,137,2019
44RDFT,Tattenhams                      ,5071,3093,9,159,1978
44RDSS,Shipping                        ,0,0,0,0,0
44REFA,Addlestone Bourneside           ,4447,2893,9,152,1554
44REFB,Addlestone North                ,4323,2978,9,182,1345
44REFC,Addlestone St.Paul's            ,4575,3159,13,121,1416
44REFD,Chertsey Meads                  ,5264,3599,32,155,1665
44REFE,Chertsey St.Ann's               ,4072,2669,10,162,1403
44REFF,Egham                           ,5320,3531,14,165,1789
44REFG,Englefield Green East           ,2256,1351,1,77,905
44REFH,Englefield Green West           ,3689,2343,7,169,1346
44REFJ,Foxhills                        ,4877,3014,13,115,1863
44REFK,Hythe                           ,4885,3159,19,242,1726
44REFL,New Haw                         ,4001,2738,12,126,1263
44REFM,Thorpe                          ,4229,2978,13,138,1251
44REFN,Virginia Water                  ,3383,1901,6,89,1482
44REFP,Woodham                         ,3886,2489,4,100,1397
44RESS,Shipping                        ,0,0,0,0,0
44RFFA,Ashford Common                  ,5043,3581,15,154,1462
44RFFB,Ashford East                    ,4761,3145,17,163,1616
44RFFC,Ashford North                   ,3483,2408,11,126,1075
44RFFD,Ashford Town                    ,5941,3979,19,190,1962
44RFFE,Ashford West                    ,1901,1378,4,61,523
44RFFF,Halliford and Sunbury West      ,5368,3578,8,218,1790
44RFFG,Laleham                         ,6031,3987,25,194,2044
44RFFH,Shepperton Green                ,4298,3009,18,137,1289
44RFFJ,Shepperton Town                 ,5403,3426,7,177,1977
44RFFK,Staines East                    ,5824,3958,15,207,1866
44RFFL,Staines Town                    ,5441,3579,9,135,1862
44RFFM,Stanwell North                  ,4094,2800,11,197,1294
44RFFN,Stanwell South                  ,3453,2314,17,163,1139
44RFFP,Sunbury Common                  ,5649,3895,17,260,1754
44RFFQ,Sunbury East                    ,5165,3470,8,151,1695
44RFFR,The Moors                       ,2545,2080,4,75,465
44RFSS,Shipping                        ,0,0,0,0,0
44RGFA,Bagshot                         ,4165,3041,10,133,1124
44RGFB,Bisley                          ,2788,2039,19,86,749
44RGFC,Chobham                         ,3397,2124,6,94,1273
44RGFD,Frimley                         ,4454,3163,8,133,1291
44RGFE,Frimley Green                   ,5780,4339,12,162,1441
44RGFF,Heatherside                     ,5691,4280,11,181,1411
44RGFG,Lightwater                      ,5103,3687,7,143,1416
44RGFH,Mytchett                        ,3426,2435,11,123,991
44RGFJ,Old Dean                        ,3386,2323,13,201,1063
44RGFK,Parkside                        ,3915,2828,28,135,1087
44RGFL,St.Michaels                     ,3000,1968,13,132,1032
44RGFM,St.Pauls                        ,3910,2539,10,101,1371
44RGFN,Town                            ,3247,1974,47,119,1273
44RGFP,Watchetts                       ,4061,2515,19,158,1546
44RGFQ,West End                        ,2689,1881,3,70,808
44RGFR,Windlesham                      ,3481,2340,2,100,1141
44RGSS,Shipping                        ,0,0,0,0,0
44RHFA,Bletchingley                    ,2253,1432,5,105,821
44RHFB,Burstow and Horne               ,4489,2899,19,157,1590
44RHFC,Chaldon                         ,1207,723,3,29,484
44RHFD,Chelsham and Farleigh Tatsfield ,1991,1237,20,65,754
44RHFE,Dormans                         ,3265,2193,9,87,1072
44RHFF,Felbridge                       ,1552,995,3,47,557
44RHFG,Godstone                        ,4508,2886,21,157,1622
44RHFH,Harestone                       ,2911,1727,7,63,1184
44RHFJ,Limpsfield                      ,2806,1584,3,55,1222
44RHFK,Lingfield and Crowhurst         ,3582,2283,7,121,1299
44RHFL,Nutfield                        ,2138,1438,7,80,700
44RHFM,Oxted North and Tandridge       ,4337,2644,14,110,1693
44RHFN,Oxted South                     ,4364,2771,18,127,1593
44RHFP,Portley                         ,2682,1710,8,77,972
44RHFQ,Queens Park                     ,2614,1576,6,71,1038
44RHFR,Valley                          ,2877,1969,5,131,908
44RHFS,Warlingham East                 ,3653,2137,7,120,1516
44RHFT,Warlingham West                 ,3179,1891,6,86,1288
44RHFU,Westway                         ,3319,2023,20,117,1296
44RHFW,Whyteleafe                      ,2601,1854,3,97,747
44RHFX,Woldingham                      ,1630,972,9,36,658
44RHSS,Shipping                        ,0,0,0,0,0
44RJFA,Alford and Dunsfold             ,1738,1066,10,59,672
44RJFB,Blackheath and Wonersh          ,1535,899,2,48,636
44RJFC,Bramley                         ,2630,1560,6,81,1070
44RJFD,BusbridgeHambledon and Hascombe ,1525,925,3,43,600
44RJFE,Chiddingfold                    ,2225,1406,3,67,819
44RJFF,Cranleigh East                  ,5461,3508,20,145,1953
44RJFG,Cranleigh West                  ,3820,2319,5,98,1501
44RJFH,ElsteadPeper Harrow and Thursle ,2660,1529,9,60,1131
44RJFJ,Ewhurst                         ,1937,1150,7,55,787
44RJFK,Farnham Bourne                  ,4860,2747,8,147,2113
44RJFL,Farnham Castle                  ,4641,2689,12,172,1952
44RJFM,FarnhamHale and Heath End       ,2578,1750,9,76,828
44RJFN,Farnham Rowledge and Wrecclesham,5581,3422,19,188,2159
44RJFP,Farnham Upper Hale              ,3852,2706,20,166,1146
44RJFQ,Farnham Waverley                ,4340,2449,11,147,1891
44RJFR,Farnham Weybourne and Badshot Le,3686,2434,11,113,1252
44RJFS,Frensham Dockenfield and Tilford,3183,1736,6,57,1447
44RJFT,Godalming North                 ,2490,1636,7,92,854
44RJFU,Godalming North East and South W,4439,2627,11,168,1812
44RJFW,Godalming North West            ,3996,2657,6,121,1339
44RJFX,Godalming South East            ,5316,3621,9,173,1695
44RJFY,Haslemere North and Grayswood   ,2822,1522,8,79,1300
44RJFZ,Haslemere South                 ,3119,1692,4,83,1427
44RJGA,Hindhead                        ,2759,1579,27,74,1180
44RJGB,Milford                         ,3068,1866,4,87,1202
44RJGC,Shamley Green                   ,1187,659,6,32,528
44RJGD,Shottermill                     ,3689,2253,13,116,1436
44RJGE,Witley                          ,2853,1740,17,104,1113
44RJSS,Shipping                        ,0,0,0,0,0
44RKFA,Brookwood                       ,1537,987,8,41,550
44RKFB,Byfleet                         ,5741,3918,14,200,1823
44RKFC,Central and Maybury             ,3744,2446,19,256,1298
44RKFD,Goldsworth Park                 ,9380,7051,30,352,2329
44RKFE,Horsell East and Woodham        ,3120,1885,7,89,1235
44RKFF,Horsell West                    ,5474,3532,21,166,1942
44RKFG,Kingfield and Westfield         ,4013,2594,16,157,1419
44RKFH,Knaphill                        ,7786,5447,27,228,2339
44RKFJ,Mayford and Sutton              ,1766,1152,1,52,614
44RKFK,Mount Hermon East               ,3683,2216,12,103,1467
44RKFL,Mount Hermon West               ,3566,2433,5,125,1133
44RKFM,Old Woking                      ,1893,1332,5,84,561
44RKFN,Pyrford                         ,4209,2563,6,101,1646
44RKFP,St.John's                       ,6442,4163,17,140,2279
44RKFQ,Sheerwater                      ,2652,1425,3,133,1227
44RKFR,West Byfleet                    ,3901,2360,9,99,1541
44RKSS,Shipping                        ,0,0,0,0,0
45RLFA,Arley                           ,2324,1407,25,145,917
45RLFB,Atherstone North                ,3784,2440,33,219,1344
45RLFC,Atherstone South                ,2738,1701,31,109,1037
45RLFD,Baddesley Ensor                 ,1534,890,21,59,644
45RLFE,Coleshill North                 ,2880,2158,13,100,722
45RLFF,Coleshill South                 ,2472,1612,11,101,860
45RLFG,Curdworth                       ,1690,1187,13,59,503
45RLFH,Dordon                          ,2433,1469,34,137,964
45RLFJ,Fillongley                      ,2594,1621,25,73,973
45RLFK,Grendon                         ,1688,994,26,56,694
45RLFL,Hartshill                       ,2707,1673,26,129,1034
45RLFM,Hurley                          ,2494,1571,27,159,923
45RLFN,Kingsbury                       ,3571,2487,30,194,1084
45RLFP,Mancetter                       ,3579,2022,48,187,1557
45RLFQ,Nether Whitacre                 ,1330,853,8,34,477
45RLFR,Newton Regis                    ,891,548,4,63,343
45RLFS,Polesworth                      ,5273,3434,81,259,1839
45RLFT,Warton                          ,1773,1217,9,81,556
45RLFU,Water Orton                     ,2858,1917,12,100,941
45RLSS,Shipping                        ,0,0,0,0,0
45RMFA,Abbey                           ,5916,3358,72,461,2558
45RMFB,Arbury                          ,6979,4972,65,343,2007
45RMFC,Attleborough                    ,5846,3231,64,327,2615
45RMFD,Bulkington                      ,6676,3993,48,301,2683
45RMFE,Camp Hill                       ,5562,3067,69,458,2495
45RMFF,Chilvers Coton                  ,5066,2898,61,319,2168
45RMFG,Exhall                          ,6038,3671,44,313,2367
45RMFH,Galley Common                   ,6516,4700,54,347,1816
45RMFJ,Heath                           ,5967,3812,59,382,2155
45RMFK,Mount Pleasant                  ,8170,5432,56,481,2738
45RMFL,Poplar                          ,5533,3475,50,379,2058
45RMFM,St.Nicholas                     ,5896,4143,36,152,1753
45RMFN,Stockingford                    ,5358,3398,62,360,1960
45RMFP,Weddington                      ,5869,3692,43,166,2177
45RMFQ,Whitestone                      ,6700,4717,46,181,1983
45RMSS,SHIPPING                        ,0,0,0,0,0
45RNFA,Admirals                        ,3663,2618,48,142,1045
45RNFB,Benn                            ,3893,2546,21,266,1347
45RNFC,Bilton                          ,4096,2505,25,123,1591
45RNFD,Brownsover                      ,4424,3201,43,286,1223
45RNFE,Caldecott                       ,4261,2610,25,144,1651
45RNFF,Clifton and Newton              ,2105,1441,5,54,664
45RNFG,Dunchurch and Thurleston        ,2361,1381,18,37,980
45RNFH,Earl Craven                     ,2859,1948,20,94,911
45RNFJ,Eastlands                       ,4593,3036,37,196,1557
45RNFK,Fosse                           ,2815,1811,23,100,1004
45RNFL,Hillmorton                      ,4527,2907,30,168,1620
45RNFM,Knightlow                       ,2350,1481,14,76,869
45RNFN,Lawford                         ,2411,1620,15,101,791
45RNFP,Leam Valley                     ,1118,709,2,31,409
45RNFQ,New Bilton                      ,4121,2682,29,251,1439
45RNFR,Newbold                         ,3902,2341,37,231,1561
45RNFS,Overslade                       ,4845,2906,36,211,1939
45RNFT,Paddox                          ,4099,2555,33,106,1544
45RNFU,Ryton-On-Dunsmore               ,1078,703,7,42,375
45RNFW,St.Mary's                       ,1056,624,4,28,432
45RNFX,Wolston                         ,1814,1144,19,68,670
45RNFY,Wolvey                          ,1528,1033,12,45,495
45RNSS,Shipping                        ,0,0,0,0,0
45RPFA,Alcester                        ,4570,2982,19,155,1588
45RPFB,Aston Cantlow                   ,1545,953,3,49,592
45RPFC,Bardon                          ,1453,904,10,37,549
45RPFD,Bidford                         ,3402,2236,18,147,1166
45RPFE,Brailes                         ,1575,857,2,45,718
45RPFF,Burton Dassett                  ,1658,1208,16,42,450
45RPFG,Claverdon                       ,1477,924,9,32,553
45RPFH,Compton                         ,1246,741,2,46,505
45RPFJ,Ettington                       ,1292,826,4,34,466
45RPFK,Farnborough                     ,1593,1018,7,63,575
45RPFL,Harbury                         ,4782,3243,23,165,1539
45RPFM,Henley                          ,2847,1634,9,74,1213
45RPFN,Kineton                         ,1668,1031,12,87,637
45RPFP,Kinwarton                       ,1671,1202,6,53,469
45RPFQ,Long Itchington                 ,1590,996,6,38,594
45RPFR,Moreton Morrell                 ,919,594,3,19,325
45RPFS,Napton Priors                   ,1307,779,5,34,528
45RPFT,Quinton                         ,1559,1009,13,32,550
45RPFU,Salford Priors                  ,1144,759,3,33,385
45RPFW,Sambourne                       ,1234,770,2,30,464
45RPFX,Shipston                        ,3147,1846,10,89,1301
45RPFY,Snitterfield                    ,1585,1038,8,49,547
45RPFZ,Southam                         ,5443,3758,27,172,1685
45RPGA,Stratford Alveston              ,4260,2487,8,77,1773
45RPGB,Stratford Guild                 ,4262,2568,20,111,1694
45RPGC,Stratford Market Hall           ,6123,4100,20,243,2023
45RPGD,Stratford New Town              ,3895,2401,11,104,1494
45RPGE,Studley                         ,4764,3183,32,166,1581
45RPGF,Tanworth                        ,1221,746,6,31,475
45RPGG,Tanworth Earlswood              ,1552,879,4,36,673
45RPGH,Tredington                      ,1914,1140,5,49,774
45RPGJ,Vale of The Red Horse           ,2004,1276,15,62,728
45RPGK,Welford                         ,1833,1104,5,38,729
45RPGL,Wellesbourne                    ,4209,2769,20,117,1440
45RPGM,Wooton Wawen                    ,1787,976,6,51,811
45RPSS,Shipping                        ,0,0,0,0,0
45RQFA,Abbey                           ,6540,3946,19,140,2594
45RQFB,Bishop's Tachbrook              ,2642,1759,8,89,883
45RQFC,Brunswick                       ,6385,3872,75,451,2513
45RQFD,Budbrooke                       ,2094,1431,8,47,663
45RQFE,Clarendon                       ,4782,3065,39,327,1717
45RQFF,Crown                           ,4649,2881,46,317,1768
45RQFG,Cubbington                      ,4677,3002,25,146,1675
45RQFH,Lapworth                        ,2494,1512,7,56,982
45RQFJ,Leek Wootton                    ,2368,1468,14,46,900
45RQFK,Manor                           ,6314,3433,31,184,2881
45RQFL,Milverton                       ,6424,3998,30,272,2426
45RQFM,Park Hill                       ,3792,2636,21,105,1156
45RQFN,Radford Semele                  ,1947,1313,8,64,634
45RQFP,St.John's                       ,7613,4698,16,187,2915
45RQFQ,Stoneleigh                      ,1702,956,9,46,746
45RQFR,Warwick North                   ,6897,4833,51,248,2064
45RQFS,Warwick South                   ,5178,3253,29,155,1925
45RQFT,Warwick West                    ,6088,3761,37,281,2327
45RQFU,Whitnash                        ,5816,3968,29,217,1848
45RQFW,Willes                          ,5940,4175,59,356,1765
45RQSS,Shipping                        ,0,0,0,0,0
46RRFA,Buckingham                      ,4002,2708,9,102,1294
46RRFB,Churchill                       ,3892,2158,13,125,1734
46RRFC,Cokeham                         ,3642,2211,17,163,1431
46RRFD,Eastbrook                       ,3586,2027,19,177,1559
46RRFE,Hillside                        ,3562,2081,21,127,1481
46RRFF,Manor                           ,3416,1999,8,98,1417
46RRFG,Marine                          ,2785,1614,10,99,1171
46RRFH,Mash Barn                       ,2941,1767,20,121,1174
46RRFJ,Peverel                         ,3205,1808,12,128,1397
46RRFK,St.Mary's                       ,909,489,4,42,420
46RRFL,St.Nicholas                     ,3913,2267,21,119,1646
46RRFM,Southlands                      ,3263,1912,17,152,1351
46RRFN,Southwick Green                 ,3967,2348,13,159,1619
46RRFP,Widewater                       ,4488,2349,16,173,2139
46RRSS,Shipping                        ,0,0,0,0,0
46RSFA,Aldingbourne                    ,2549,1541,8,76,1008
46RSFB,Aldwick East                    ,4361,1784,12,85,2577
46RSFC,Aldwick West                    ,4919,2229,15,121,2690
46RSFD,Angmering                       ,5223,2910,24,142,2313
46RSFE,Arundel                         ,3226,1842,11,115,1384
46RSFF,Barnham                         ,6976,4296,39,268,2680
46RSFG,Bersted                         ,6342,3993,29,261,2349
46RSFH,East Preston and Kingston       ,5186,2202,23,130,2984
46RSFJ,Felpham East                    ,4271,2224,11,105,2047
46RSFK,Felpham West                    ,3464,1592,10,102,1872
46RSFL,Ferring                         ,3785,1336,12,93,2449
46RSFM,Findon                          ,1542,725,6,31,817
46RSFN,Hotham                          ,4745,2744,23,214,2001
46RSFP,Littlehampton Beach             ,4127,2227,12,149,1900
46RSFQ,Littlehampton Central           ,4522,3073,28,195,1449
46RSFR,Littlehampton Ham               ,3264,1985,16,227,1279
46RSFS,Littlehampton River             ,2582,1431,10,163,1151
46RSFT,Littlehampton Wick              ,4209,2521,14,190,1688
46RSFU,Marine                          ,4593,2347,29,232,2246
46RSFW,Middleton-on-Sea                ,4040,1894,11,111,2146
46RSFX,Orchard                         ,3327,1973,20,162,1354
46RSFY,Pagham                          ,4374,1807,29,149,2567
46RSFZ,Pevensey                        ,4046,2205,20,210,1841
46RSGA,Rustington East                 ,4068,1586,9,121,2482
46RSGB,Rustington North                ,3161,1541,9,70,1620
46RSGC,Rustington South                ,2948,1117,7,55,1831
46RSGD,Walberton                       ,2261,1195,7,66,1066
46RSSS,Shipping                        ,0,0,0,0,0
46RTFA,Birdham                         ,1538,785,8,45,753
46RTFB,Bosham                          ,2188,1151,19,73,1037
46RTFC,Boxgrove                        ,1335,728,1,38,607
46RTFD,Bury                            ,1124,643,4,27,481
46RTFE,Chichester East                 ,5611,3579,46,277,2032
46RTFF,Chichester North                ,5079,2970,20,118,2109
46RTFG,Chichester South                ,4361,2598,33,155,1763
46RTFH,Chichester West                 ,4438,2258,22,129,2180
46RTFJ,Donnington                      ,1547,883,4,30,664
46RTFK,Easebourne                      ,1542,902,4,51,640
46RTFL,East Wittering                  ,3223,1640,13,96,1583
46RTFM,Fernhurst                       ,2503,1423,6,67,1080
46RTFN,Fishbourne                      ,1523,853,3,28,670
46RTFP,Funtington                      ,1989,1174,12,60,815
46RTFQ,Graffham                        ,1454,799,5,31,655
46RTFR,Harting                         ,1413,797,3,27,616
46RTFS,Hunston                         ,1869,1090,4,57,779
46RTFT,Lavant                          ,1636,1037,5,52,599
46RTFU,Linchmere                       ,1284,816,4,25,468
46RTFW,Lodsworth                       ,1479,797,5,45,682
46RTFX,Midhurst                        ,4088,2187,13,106,1901
46RTFY,Oving                           ,1933,1305,10,84,628
46RTFZ,Petworth                        ,3126,1895,11,86,1231
46RTGA,Plaistow                        ,3192,1951,9,94,1241
46RTGB,Rogate                          ,1476,823,4,36,653
46RTGC,Selsey North                    ,3618,1683,12,127,1935
46RTGD,Selsey South                    ,3863,1787,5,117,2076
46RTGE,Sidlesham                       ,955,584,3,43,371
46RTGF,Southbourne                     ,5622,3414,28,167,2208
46RTGG,Stedham                         ,1709,982,2,54,727
46RTGH,Stoughton                       ,1336,840,0,46,496
46RTGJ,Westbourne                      ,1659,1007,5,80,652
46RTGK,West Wittering                  ,2393,955,7,75,1438
46RTGL,Wisborough Green                ,1924,1088,9,58,836
46RTSS,Shipping                        ,0,0,0,0,0
46RUFA,Bewbush                         ,5617,4265,36,435,1352
46RUFB,Broadfield                      ,8034,6227,34,565,1807
46RUFC,Furnace Green                   ,5344,3779,18,229,1565
46RUFD,Gossops Green                   ,4217,2859,15,182,1358
46RUFE,Ifield                          ,7018,4790,26,347,2228
46RUFF,Langley Green                   ,5439,3592,19,390,1847
46RUFG,Northgate                       ,3600,2289,19,172,1311
46RUFH,Pound Hill North                ,5284,3785,29,222,1499
46RUFJ,Pound Hill South                ,5247,3742,26,198,1505
46RUFK,Southgate                       ,6216,4118,23,322,2098
46RUFL,Three Bridges                   ,4203,2664,21,197,1539
46RUFM,Tilgate                         ,5084,3391,7,249,1693
46RUFN,West Green                      ,3617,2152,13,143,1465
46RUSS,Shipping                        ,0,0,0,0,0
46RWFA,Billingshurst                   ,4645,3134,20,155,1511
46RWFB,Bramber and Upper Beeding       ,3578,2271,16,121,1307
46RWFC,Broadbridge Heath               ,2373,1767,3,93,606
46RWFD,Chanctonbury                    ,3821,2480,12,115,1341
46RWFE,Cowfold                         ,2120,1337,1,69,783
46RWFF,Denne                           ,5608,3598,17,179,2010
46RWFG,Forest                          ,5445,3732,14,189,1713
46RWFH,Henfield                        ,4718,2726,12,126,1992
46RWFJ,Holbrook                        ,4984,3733,13,179,1251
46RWFK,Itchingfield and Shipley        ,2056,1364,14,66,692
46RWFL,Nuthurst                        ,1373,879,1,29,494
46RWFM,Pulborough                      ,4193,2549,10,112,1644
46RWFN,Riverside                       ,6693,4308,23,228,2385
46RWFP,Roffey North                    ,4916,3402,13,183,1514
46RWFQ,Rudgwick                        ,1793,1191,4,54,602
46RWFR,Rusper                          ,1794,1264,6,73,530
46RWFS,Slinfold                        ,1395,814,3,55,581
46RWFT,Southwater                      ,5186,3847,11,158,1339
46RWFU,Steyning                        ,4601,2580,10,144,2021
46RWFW,Storrington                     ,3934,2060,22,89,1874
46RWFX,Sullington                      ,1769,843,3,64,926
46RWFY,Trafalgar                       ,4562,2689,14,131,1873
46RWFZ,Warnham                         ,1416,900,8,59,516
46RWGA,West Chiltington                ,2746,1353,5,68,1393
46RWGB,West Grinstead                  ,2088,1508,8,69,580
46RWSS,Shipping                        ,0,0,0,0,0
46RXFA,Ardingly                        ,1273,801,5,30,472
46RXFB,Balcombe                        ,1474,865,3,40,609
46RXFC,Bolney                          ,1634,1070,9,63,564
46RXFD,Burgess Hill-Chanctonbury       ,1921,1168,8,55,753
46RXFE,Burgess Hill-Franklands         ,4115,2656,16,110,1459
46RXFF,Burgess Hill-North              ,4496,3431,21,174,1065
46RXFG,Burgess Hill-St.Andrews         ,3728,2622,14,128,1106
46RXFH,Burgess Hill-Town               ,2965,1730,6,87,1235
46RXFJ,Burgess Hill-West               ,3006,2108,15,114,898
46RXFK,Clayton                         ,1571,804,4,44,767
46RXFL,Copthorne and Worth             ,3334,2368,5,122,966
46RXFM,Crawley Down                    ,4160,2928,7,128,1232
46RXFN,Cuckfield                       ,3334,2030,20,114,1304
46RXFP,East Grinstead East             ,1578,1024,5,52,554
46RXFQ,East Grinstead North            ,6413,4509,11,184,1904
46RXFR,East Grinstead South            ,6140,4433,17,196,1707
46RXFS,East Grinstead West             ,5336,3358,18,146,1978
46RXFT,Haywards Heath Ashenground      ,3906,2753,13,114,1153
46RXFU,Haywards Heath Bentswood        ,2833,1720,10,101,1113
46RXFW,Haywards Heath Franklands       ,4978,3289,20,129,1689
46RXFX,Haywards Heath Harlands         ,3567,2202,6,89,1365
46RXFY,Haywards Heath-Heath            ,2954,1695,6,91,1259
46RXFZ,Horsted Keynes                  ,1195,729,3,27,466
46RXGA,Hurstpierpoint                  ,5117,3012,19,132,2105
46RXGB,Keymer                          ,4462,2511,9,112,1951
46RXGC,Lindfield Rural                 ,2000,1232,8,40,768
46RXGD,Lindfield Urban                 ,4698,2631,19,115,2067
46RXGE,Slaugham                        ,2224,1401,8,64,823
46RXGF,Turners Hill                    ,1293,779,4,49,514
46RXGG,West Hoathly                    ,1700,1147,8,45,553
46RXSS,Shipping                        ,0,0,0,0,0
46RYFA,Broadwater                      ,6694,4254,30,265,2440
46RYFB,Castle                          ,6318,3631,38,207,2687
46RYFC,Central                         ,6225,3514,44,380,2711
46RYFD,Durrington                      ,7708,4827,17,246,2881
46RYFE,Gaisford                        ,6642,3977,34,282,2665
46RYFF,Goring                          ,6875,2832,18,135,4043
46RYFG,Heene                           ,6962,2765,33,231,4197
46RYFH,Marine                          ,6379,3043,28,194,3336
46RYFJ,Offington                       ,6440,3377,20,167,3063
46RYFK,Salvington                      ,6655,3381,14,178,3274
46RYFL,Selden                          ,6487,3591,35,305,2896
46RYFM,Tarring                         ,6763,3981,30,196,2782
46RYSS,Shipping                        ,0,0,0,0,0
47RZFA,Aldbourne                       ,1774,1083,7,56,691
47RZFB,Bedwyn                          ,1430,810,7,47,620
47RZFC,Bromham                         ,1538,1006,14,48,532
47RZFD,Burbage                         ,1595,997,6,60,598
47RZFE,Cannings                        ,1348,922,5,68,426
47RZFF,Cheverell                       ,1698,1058,12,46,640
47RZFG,Collingbourne                   ,1163,804,12,43,359
47RZFH,Devizes East                    ,3839,2473,14,186,1366
47RZFJ,Devizes North                   ,2300,1507,20,140,793
47RZFK,Devizes South                   ,2941,1678,13,97,1263
47RZFL,Ludgershall                     ,2670,1861,14,93,809
47RZFM,Market Lavington                ,1915,1283,18,63,632
47RZFN,Marlborough East                ,2934,1848,7,101,1086
47RZFP,Marlborough West                ,2518,1600,8,79,918
47RZFQ,Milton Lilbourne                ,846,491,2,31,355
47RZFR,Netheravon                      ,1799,1277,16,49,522
47RZFS,North Tidworth                  ,4031,3090,50,143,941
47RZFT,Ogbourne                        ,912,603,3,28,309
47RZFU,Pewsey                          ,2343,1305,10,58,1038
47RZFW,Potterne                        ,1299,746,5,47,553
47RZFX,Ramsbury                        ,1750,1056,9,43,694
47RZFY,Roundway                        ,1328,795,5,46,533
47RZFZ,Seend                           ,1917,1247,8,56,670
47RZGA,Shalbourne                      ,1101,677,2,38,424
47RZGB,Upavon                          ,1202,807,5,40,395
47RZGC,Urchfont                        ,953,508,3,27,445
47RZGD,West Lavington                  ,883,506,4,19,377
47RZGE,West Overton                    ,997,660,6,24,337
47RZGF,West Selkley                    ,1225,814,4,51,411
47RZGG,Wilcot                          ,1133,664,8,37,469
47RZGH,Woodborough                     ,1196,745,5,36,451
47RZSS,Shipping                        ,0,0,0,0,0
47SAFA,Allington                       ,1697,1088,11,47,609
47SAFB,Ashton Keynes                   ,1302,822,2,35,480
47SAFC,Audley                          ,1630,1064,19,72,566
47SAFD,Avon                            ,1741,1132,8,49,609
47SAFE,Box                             ,3113,2044,15,79,1069
47SAFF,Bremhill                        ,1676,1055,12,53,621
47SAFG,Brinkworth                      ,1308,893,9,41,415
47SAFH,Calne Abberd                    ,1620,1023,16,95,597
47SAFJ,Calne Central                   ,1972,1165,7,56,807
47SAFK,Calne North                     ,1673,1111,5,92,562
47SAFL,Calne North East                ,1656,1055,13,74,601
47SAFM,Calne South                     ,2092,1434,6,68,658
47SAFN,Calne Without                   ,1914,1225,6,67,689
47SAFP,Colerne                         ,1932,1356,14,52,576
47SAFQ,Corsham                         ,3365,2029,16,121,1336
47SAFR,Cricklade                       ,3635,2480,23,124,1155
47SAFS,Crudwell                        ,904,604,5,22,300
47SAFT,Hill Rise                       ,1362,788,8,54,574
47SAFU,Hilmarton                       ,1395,856,8,43,539
47SAFW,Kington Langley                 ,2116,1442,11,55,674
47SAFX,Kington St.Michael              ,1810,1128,5,24,682
47SAFY,Lacock                          ,874,572,6,27,302
47SAFZ,Lyneham                         ,4526,3435,54,129,1091
47SAGA,Malmesbury                      ,3407,2178,19,105,1229
47SAGB,Malmesbury Road                 ,1327,756,6,48,571
47SAGC,Minety                          ,1981,1249,9,52,732
47SAGD,Monkton Park                    ,1592,907,2,31,685
47SAGE,Neston and Gastard              ,1330,848,6,37,482
47SAGF,Nettleton                       ,1382,873,5,23,509
47SAGG,Park                            ,1238,775,1,37,463
47SAGH,Pickwick                        ,3757,2323,22,157,1434
47SAGJ,Purton                          ,3203,2026,11,103,1177
47SAGK,Queen's                         ,1687,1254,9,34,433
47SAGL,Redland                         ,1718,1116,18,50,602
47SAGM,St.Paul Malmesbury Without      ,2082,1341,16,55,741
47SAGN,Sherston                        ,1702,1064,4,39,638
47SAGP,Somerford                       ,1511,929,4,32,582
47SAGQ,The Lydiards                    ,1349,864,1,43,485
47SAGR,Town                            ,4822,3581,23,164,1241
47SAGS,Westcroft                       ,1443,871,3,68,572
47SAGT,Wootton Bassett North           ,3791,2572,16,129,1219
47SAGU,Wootton Bassett South           ,4647,3195,23,127,1452
47SASS,Shipping                        ,0,0,0,0,0
47SBFA,Alderbury                       ,2258,1444,8,57,814
47SBFB,Amesbury                        ,5333,3527,27,184,1806
47SBFC,Bemerton                        ,4558,3119,27,266,1439
47SBFD,Bishopdown                      ,1764,979,7,61,785
47SBFE,Bulford                         ,4467,3489,58,120,978
47SBFF,Chalke Valley                   ,1481,902,5,43,579
47SBFG,Donhead                         ,1430,749,6,47,681
47SBFH,Downton                         ,2277,1382,7,64,895
47SBFJ,Durrington                      ,5211,3917,52,132,1294
47SBFK,Ebble                           ,1370,822,8,46,548
47SBFL,Fisherton and Bemerton Village  ,2962,1851,11,111,1111
47SBFM,Fonthill                        ,1035,591,3,35,444
47SBFN,Fovant                          ,970,495,5,32,475
47SBFP,Harnham                         ,5135,3017,20,159,2118
47SBFQ,Idmiston                        ,1781,1195,10,43,586
47SBFR,Knoyle                          ,1103,598,4,32,505
47SBFS,Laverstock                      ,2547,1557,13,57,990
47SBFT,Mere                            ,1902,978,5,48,924
47SBFU,Milford                         ,2627,1595,17,104,1032
47SBFW,Nadder                          ,1314,713,5,27,601
47SBFX,Redlynch                        ,2550,1564,5,54,986
47SBFY,St.Edmund                       ,2185,1468,17,102,717
47SBFZ,St.Mark                         ,3532,2123,16,90,1409
47SBGA,St.Martin                       ,2608,1455,12,133,1153
47SBGB,St.Paul                         ,3492,2401,16,125,1091
47SBGC,Stratford                       ,1474,758,7,59,716
47SBGD,Till Valley                     ,1930,1225,10,53,705
47SBGE,Tisbury                         ,1976,1142,7,47,834
47SBGF,Upper Bourne                    ,839,530,4,23,309
47SBGG,Western                         ,1205,673,3,43,532
47SBGH,Whiteparish                     ,2055,1219,5,48,836
47SBGJ,Wilton                          ,3417,2196,18,120,1221
47SBGK,Winterbourne                    ,2291,1428,11,65,863
47SBGL,Winterslow                      ,2018,1268,10,42,750
47SBGM,Woodford Valley                 ,0,0,0,0,0
47SBGN,Wylye                           ,2154,1305,11,69,849
47SBSS,Shipping                        ,0,0,0,0,0
47SCFA,Blunsdon                        ,2372,1554,7,89,818
47SCFB,Central                         ,6190,4140,25,489,2050
47SCFC,Chiseldon                       ,2157,1401,8,71,756
47SCFD,Covingham                       ,3261,2504,7,93,757
47SCFE,Dorcan                          ,7455,5597,56,337,1858
47SCFF,Eastcott                        ,7172,5170,57,430,2002
47SCFG,Freshbrook                      ,6874,5431,24,274,1443
47SCFH,Gorse Hill                      ,7180,4545,44,511,2635
47SCFJ,Haydon Wick                     ,5986,4501,24,172,1485
47SCFK,Highworth                       ,6880,4656,29,215,2224
47SCFL,Lawns                           ,7921,4638,46,232,3283
47SCFM,Moredon                         ,6991,4502,41,409,2489
47SCFN,Park                            ,7887,4946,62,736,2941
47SCFP,Ridgeway                        ,2503,1653,7,68,850
47SCFQ,St.Margaret                     ,10882,7903,43,312,2979
47SCFR,St.Philip                       ,6263,4266,38,279,1997
47SCFS,Toothill                        ,11796,9353,41,479,2443
47SCFT,Walcot                          ,6110,3625,46,447,2485
47SCFU,Western                         ,7433,4905,37,329,2528
47SCFW,Whitworth                       ,5809,3514,35,580,2295
47SCFX,Wroughton                       ,5925,3792,31,203,2133
47SCSS,Shipping                        ,0,0,0,0,0
47SDFA,Adcroft                         ,2774,1655,12,149,1119
47SDFB,Blackmore Forest                ,3441,2482,15,121,959
47SDFC,Bradford-on-Avon North          ,3519,2103,12,102,1416
47SDFD,Bradford-on-Avon South          ,3710,2275,10,131,1435
47SDFE,College                         ,4191,2912,17,194,1279
47SDFF,Corsley                         ,1305,812,7,32,493
47SDFG,Ditton Marsh                    ,1501,982,14,82,519
47SDFH,Drynham                         ,3943,2822,21,167,1121
47SDFJ,Ethandune                       ,1679,984,9,68,695
47SDFK,Holt                            ,2221,1345,12,63,876
47SDFL,John O'Gaunt                    ,5067,3404,36,246,1663
47SDFM,Manor Vale                      ,3402,2023,14,106,1379
47SDFN,Melksham Forest                 ,1822,1132,12,113,690
47SDFP,Melksham Lambourne              ,2002,1115,13,96,887
47SDFQ,Melksham Roundpond              ,1703,1107,9,68,596
47SDFR,Melksham Town                   ,2673,1665,16,64,1008
47SDFS,Melksham Woodrow                ,2280,1697,16,73,583
47SDFT,Mid Wylye Valley                ,1256,768,4,28,488
47SDFU,Park                            ,4008,2378,13,138,1630
47SDFW,Paxcroft                        ,2389,1567,8,66,822
47SDFX,Shearwater                      ,1310,779,9,28,531
47SDFY,Summerham                       ,2137,1326,12,62,811
47SDFZ,Warminster East                 ,6225,3792,39,226,2433
47SDGA,Warminster West                 ,6756,4248,37,253,2508
47SDGB,Weavers                         ,3929,2660,22,119,1269
47SDGC,Westbrook                       ,1910,1131,7,46,779
47SDGD,Westbury with Storridge         ,8025,5073,40,355,2952
47SDGE,Wylye Valley                    ,1236,661,3,39,575
47SDSS,Shipping                        ,0,0,0,0,0
48SEFA,Aston                           ,2829,1804,20,100,1025
48SEFB,Buckley Bistre East             ,2841,1825,28,122,1016
48SEFC,Buckley Bistre West             ,3598,2271,40,209,1327
48SEFD,Buckley Mountain                ,1662,1042,13,54,620
48SEFE,Buckley Pentrobin               ,2857,1768,24,96,1089
48SEFF,Caergwrle                       ,1425,846,18,91,579
48SEFG,Connah's Quay Central           ,2685,1529,21,136,1156
48SEFH,Connah's Quay Golftyn           ,3322,2353,28,171,969
48SEFJ,Connah's Quay South             ,3519,2534,31,140,985
48SEFK,Connah's Quay Wepre             ,1762,1039,18,74,723
48SEFL,Ewloe                           ,2606,1681,15,71,925
48SEFM,Hawarden                        ,1617,910,5,40,707
48SEFN,Higher and East Shotton         ,3369,1846,32,213,1523
48SEFP,Higher Kinnerton                ,1225,856,3,28,369
48SEFQ,Hope                            ,1867,1175,18,64,692
48SEFR,Llanfynydd                      ,1432,864,13,58,568
48SEFS,Mancot                          ,2443,1459,17,95,984
48SEFT,North and East Broughton        ,1654,1010,15,54,644
48SEFU,Penyffordd                      ,2761,1775,29,91,986
48SEFW,Queensferry                     ,1567,991,7,89,576
48SEFX,Saltney                         ,3519,2240,24,206,1279
48SEFY,Sealand                         ,2328,1430,19,138,898
48SEFZ,South Broughton                 ,2657,1858,13,94,799
48SEGA,Treuddyn                        ,1237,749,14,42,488
48SEGB,West Shotton                    ,1595,955,5,73,640
48SESS,Shipping                        ,0,0,0,0,0
48SFFA,Betws yn Rhos                   ,0,0,0,0,0
48SFFB,Colwyn                          ,3467,1881,30,143,1586
48SFFC,Dinarth                         ,2335,975,16,46,1360
48SFFD,Eirias                          ,2809,1508,23,80,1301
48SFFE,Gele                            ,3727,1407,11,78,2320
48SFFF,Glyn                            ,3409,2041,51,226,1368
48SFFG,Kinmel Bay                      ,3692,1713,37,193,1979
48SFFH,Llanddulas                      ,1298,770,12,49,528
48SFFJ,Llanfair Talhaiarn              ,1253,827,11,43,426
48SFFK,Llangernyw                      ,1124,677,7,33,447
48SFFL,Llansannan                      ,1039,627,16,34,412
48SFFM,Llysfaen                        ,2593,1613,25,172,980
48SFFN,Mochdre                         ,1577,916,13,78,661
48SFFP,Pentre Mawr                     ,4613,2024,33,256,2589
48SFFQ,Rhiw                            ,4262,2256,24,206,2006
48SFFR,Rhos                            ,3881,1537,22,143,2344
48SFFS,Towyn                           ,1620,739,17,84,881
48SFFT,Trefnant                        ,1482,719,9,43,763
48SFFU,Uwchaled                        ,1137,666,14,37,471
48SFSS,Shipping                        ,0,0,0,0,0
48SGFA,Bagillt East                    ,2132,1335,17,94,797
48SGFB,Bagillt West                    ,974,565,11,58,409
48SGFC,Caerwys                         ,1853,1108,11,50,745
48SGFD,Castle                          ,1793,843,15,103,950
48SGFE,Cilcain                         ,1482,919,11,35,563
48SGFF,Coleshill                       ,2922,1820,34,135,1102
48SGFG,Ffynnongroyw                    ,1843,894,10,99,949
48SGFH,Greenfield                      ,2070,1285,20,152,785
48SGFJ,Gronant                         ,1238,671,12,82,567
48SGFK,Gwernaffield                    ,1503,857,8,33,646
48SGFL,Gwernymynydd                    ,1373,853,11,37,520
48SGFM,Halkyn                          ,3058,1928,35,101,1130
48SGFN,Holywell East                   ,2503,1422,40,168,1081
48SGFP,Holywell West                   ,2255,1209,18,135,1046
48SGFQ,Leeswood                        ,1656,1035,25,108,621
48SGFR,Mold Bron Coed                  ,1068,653,7,50,415
48SGFS,Mold Central                    ,1311,775,6,54,536
48SGFT,Mold East                       ,1154,714,13,37,440
48SGFU,Mold North                      ,1380,792,15,53,588
48SGFW,Mold South                      ,1320,841,14,30,479
48SGFX,Mold West                       ,1075,530,12,76,545
48SGFY,Mostyn                          ,1516,826,18,77,690
48SGFZ,Mynydd Isa East                 ,2367,1617,19,65,750
48SGGA,New Brighton                    ,2334,1575,18,74,759
48SGGB,Northop                         ,3313,2136,20,102,1177
48SGGC,Oakenholt                       ,2367,1419,14,137,948
48SGGD,Trelawny                        ,2698,1806,17,96,892
48SGGE,Trelawnyd and Gwaenysgor        ,1368,762,2,49,606
48SGGF,Whitford                        ,1911,1178,24,50,733
48SGSS,Shipping                        ,0,0,0,0,0
48SHFA,Ceiriog Ganol                   ,1430,794,15,72,636
48SHFB,Chirk North                     ,1798,1114,15,108,684
48SHFC,Chirk South                     ,1408,775,11,48,633
48SHFD,Corwen                          ,1880,1106,19,94,774
48SHFE,Denbigh Central                 ,1661,1092,19,79,569
48SHFF,Denbigh Lower                   ,3158,1955,21,64,1203
48SHFG,Denbigh Upper                   ,2602,1415,21,171,1187
48SHFH,Efenechtyd                      ,1655,987,17,55,668
48SHFJ,Gwyddelwern                     ,0,0,0,0,0
48SHFK,Henllan                         ,0,0,0,0,0
48SHFL,Llanarmon-yn-Ial                ,2057,1231,20,88,826
48SHFM,Llanbedr Dyffryn Clwyd          ,1136,587,10,27,549
48SHFN,Llandegla                       ,0,0,0,0,0
48SHFP,Llandrillo                      ,829,448,5,17,381
48SHFQ,Llandyrnog                      ,1054,555,3,27,499
48SHFR,Llanfair Dyffryn Clwyd          ,1097,641,8,20,456
48SHFS,Llangollen                      ,2719,1445,23,114,1274
48SHFT,Llangollen Rural                ,1906,1080,19,67,826
48SHFU,Llanrhaeadr-ym-Mochnant         ,0,0,0,0,0
48SHFW,Llanrhaeadr-yng-Nghinmeirch     ,1088,631,4,22,457
48SHFX,Llansilin                       ,1500,904,13,45,596
48SHFY,Llanynys                        ,880,534,9,20,346
48SHFZ,Ruthin                          ,4142,2165,22,125,1977
48SHSS,Shipping                        ,0,0,0,0,0
48SJFA,Bodelwyddan                     ,1340,849,17,75,491
48SJFB,Dyserth                         ,1900,1070,19,70,830
48SJFC,Meliden                         ,1630,819,11,96,811
48SJFD,Prestatyn Central               ,2733,1288,8,119,1445
48SJFE,Prestatyn East                  ,3119,1552,18,125,1567
48SJFF,Prestatyn North                 ,4094,1634,27,132,2460
48SJFG,Prestatyn South West            ,2651,1163,14,111,1488
48SJFH,Rhuddlan                        ,2996,1537,17,88,1459
48SJFJ,Rhyl East                       ,3918,1589,25,211,2329
48SJFK,Rhyl South                      ,3080,1469,18,102,1611
48SJFL,Rhyl South East                 ,5053,2832,30,203,2221
48SJFM,Rhyl South West                 ,3842,2049,55,292,1793
48SJFN,Rhyl West                       ,3961,2242,82,595,1719
48SJFP,St. Asaph East                  ,1413,866,4,42,547
48SJFQ,St. Asaph West                  ,1356,720,14,64,636
48SJFR,Tremeirchion                    ,1196,718,10,28,478
48SJSS,Shipping                        ,0,0,0,0,0
48SKFA,Acton                           ,2651,1330,36,115,1321
48SKFB,Borras Park                     ,2285,1409,31,68,876
48SKFC,Bronington                      ,2383,1443,31,66,940
48SKFD,Brymbo                          ,2147,1174,106,115,973
48SKFE,Bryn Cefn                       ,1438,886,47,75,552
48SKFF,Caia Park                       ,4243,2316,59,397,1927
48SKFG,Cefn                            ,3908,2191,54,209,1717
48SKFH,Coedpoeth                       ,3742,2284,91,226,1458
48SKFJ,Esclusham                       ,2378,1354,29,103,1024
48SKFK,Garden Village                  ,1688,915,14,49,773
48SKFL,Gresford East and West          ,2239,1266,18,84,973
48SKFM,Grosvenor                       ,1726,905,20,70,821
48SKFN,Gwenfro                         ,1375,762,37,111,613
48SKFP,Gwersyllt East and South        ,2982,1958,34,155,1024
48SKFQ,Gwersyllt North                 ,1918,1236,44,164,682
48SKFR,Gwersyllt West                  ,2242,1428,34,128,814
48SKFS,Holt                            ,1662,962,13,55,700
48SKFT,Johnstown                       ,2469,1495,29,101,974
48SKFU,Little Acton                    ,1959,1167,16,57,792
48SKFW,Llay                            ,3793,2367,50,228,1426
48SKFX,Maesydre                        ,1695,862,16,61,833
48SKFY,Marchwiel                       ,1727,1110,18,51,617
48SKFZ,Marford and Hoseley             ,1741,1108,6,41,633
48SKGA,Minera                          ,1858,1166,36,84,692
48SKGB,New Broughton                   ,2267,1372,56,128,895
48SKGC,Offa East                       ,4532,2532,52,243,2000
48SKGD,Offa West                       ,2816,1751,46,174,1065
48SKGE,Overton                         ,2187,1254,18,59,933
48SKGF,Pant                            ,1714,892,15,77,822
48SKGG,Penycae                         ,2626,1534,30,169,1092
48SKGH,Plas Madoc                      ,1666,796,24,186,870
48SKGJ,Ponciau                         ,3172,1650,28,128,1522
48SKGK,Queensway                       ,3610,2005,57,438,1605
48SKGL,Rhosnesni                       ,2176,1481,20,68,695
48SKGM,Rossett                         ,2371,1402,13,79,969
48SKGN,Ruabon                          ,2527,1375,34,113,1152
48SKGP,Stansty                         ,1839,1090,23,67,749
48SKGQ,Whitegate                       ,1559,1001,21,101,558
48SKSS,Shipping                        ,0,0,0,0,0
49SLFA,Abergwili                       ,1594,949,29,51,645
49SLFB,Carmarthen Town North           ,4188,2278,51,215,1910
49SLFC,Carmarthen Town South           ,2948,1593,32,99,1355
49SLFD,Carmarthen Town West            ,2886,1462,31,106,1424
49SLFE,Cenarth                         ,1638,850,20,58,788
49SLFF,Clynderwen                      ,1104,681,19,46,423
49SLFG,Cynwyl Elfed                    ,1302,736,20,41,566
49SLFH,Gorslas                         ,2805,1424,23,103,1381
49SLFJ,Laugharne Township              ,986,561,10,43,425
49SLFK,Llanboidy                       ,1321,806,17,41,515
49SLFL,Llanddarog                      ,1504,861,16,50,643
49SLFM,Llanddowror                     ,1288,738,19,46,550
49SLFN,Llandyfaelog                    ,1009,598,6,33,411
49SLFP,Llanfihangel-ar-Arth            ,1663,918,16,59,745
49SLFQ,Llangeler                       ,2492,1276,37,123,1216
49SLFR,Llangunnor                      ,1893,1066,21,63,827
49SLFS,Llangyndeyrn                    ,2338,1215,43,134,1123
49SLFT,Llanllwni                       ,884,489,16,20,395
49SLFU,Llansteffan                     ,1527,928,28,42,599
49SLFW,Llanybydder                     ,1209,681,14,53,528
49SLFX,Newchurch                       ,922,535,9,18,387
49SLFY,Pencarreg                       ,1007,589,13,38,418
49SLFZ,St.Clears                       ,2395,1363,25,72,1032
49SLGA,St.Ishmael                      ,1109,589,32,37,520
49SLGB,Trelech                         ,1205,791,15,43,414
49SLGC,Whitland                        ,1251,698,9,66,553
49SLSS,Shipping                        ,0,0,0,0,0
49SMFA,Aberaeron                       ,1300,620,25,43,680
49SMFB,Aberporth                       ,1747,851,26,56,896
49SMFC,Aberystwyth East                ,936,473,12,35,463
49SMFD,Aberystwyth North               ,1791,901,26,82,890
49SMFE,Aberystwyth South               ,2284,1355,32,104,929
49SMFF,Aberystwyth West                ,2058,1054,22,99,1004
49SMFG,Beulah                          ,1219,660,12,39,559
49SMFH,Borth                           ,1593,855,18,86,738
49SMFJ,Capel Dewi                      ,1050,578,17,42,472
49SMFK,Cardigan                        ,3606,1798,54,156,1808
49SMFL,Ceulanamaesmawr                 ,1426,829,21,49,597
49SMFM,Ciliau Aeron                    ,1293,693,22,50,600
49SMFN,Faenor                          ,1410,779,9,32,631
49SMFP,Lampeter                        ,1691,853,15,67,838
49SMFQ,Llanarth                        ,1038,564,10,42,474
49SMFR,Llanbadarn Fawr                 ,1214,638,12,37,576
49SMFS,Llandyfriog                     ,1389,691,10,74,698
49SMFT,Llandysiliogogo                 ,2179,1104,31,91,1075
49SMFU,Llandysul Town                  ,1133,568,7,50,565
49SMFW,Llanfarian                      ,974,575,6,16,399
49SMFX,Llanfihangel Ystrad             ,1539,877,25,61,662
49SMFY,Llangeitho                      ,1185,626,12,54,559
49SMFZ,Llangybi                        ,1124,627,19,65,497
49SMGA,Llanrhystyd                     ,1003,596,17,41,407
49SMGB,Llansantffraid                  ,1697,901,18,67,796
49SMGC,Llanwenog                       ,1314,775,17,44,539
49SMGD,Lledrod                         ,1615,899,17,65,716
49SMGE,Melindwr                        ,1440,835,24,49,605
49SMGF,New Quay                        ,0,0,0,0,0
49SMGG,Penbryn                         ,1623,836,20,75,787
49SMGH,Penparc                         ,1835,910,20,61,925
49SMGJ,Tirymynach                      ,1258,753,11,31,505
49SMGK,Trefeurig                       ,1057,658,11,25,399
49SMGL,Tregaron                        ,960,518,12,38,442
49SMGM,Troedyraur                      ,992,521,22,38,471
49SMGN,Ystwyth                         ,1366,804,14,44,562
49SMSS,Shipping                        ,0,0,0,0,0
49SNFA,Ammanford                       ,1252,571,15,66,681
49SNFB,Betws                           ,1389,703,21,98,686
49SNFC,Brynamman                       ,0,0,0,0,0
49SNFD,Castle                          ,1397,667,7,50,730
49SNFE,Cynwyl Gaeo                     ,1130,651,14,47,479
49SNFF,Ffairfach                       ,928,501,11,37,427
49SNFG,Garnant                         ,1672,802,13,95,870
49SNFH,Glanamman                       ,1769,802,28,108,967
49SNFJ,Llandeilo                       ,0,0,0,0,0
49SNFK,Llandovery                      ,1696,848,15,54,848
49SNFL,Llandybie                       ,2918,1482,32,134,1436
49SNFM,Llanegwad                       ,1426,876,14,51,550
49SNFN,Llanfair-ar-y-Bryn              ,855,470,12,26,385
49SNFP,Llanfihangel Aberbythych        ,1812,1028,15,73,784
49SNFQ,Llangadog                       ,1413,838,15,48,575
49SNFR,Llynfell                        ,0,0,0,0,0
49SNFS,Manordeilo                      ,1974,1100,20,67,874
49SNFT,Myddfai                         ,0,0,0,0,0
49SNFU,Myddnfych                       ,951,450,20,60,501
49SNFW,Pantyffynnon                    ,995,464,4,51,531
49SNFX,Penygroes                       ,1786,920,29,76,866
49SNFY,Pontamman                       ,1042,571,7,48,471
49SNFZ,Quarter Bach                    ,2399,1135,20,136,1264
49SNGA,Saron                           ,2599,1304,22,156,1295
49SNGB,Talley                          ,0,0,0,0,0
49SNSS,Shipping                        ,0,0,0,0,0
49SPFA,Bigyn                           ,4946,2432,66,272,2514
49SPFB,Burry Port                      ,3582,1706,55,189,1876
49SPFC,Bynea                           ,2269,1088,41,119,1181
49SPFD,Cross Hands                     ,1151,604,14,81,547
49SPFE,Dafen                           ,2330,1240,25,123,1090
49SPFF,Elli                            ,2703,1207,21,106,1496
49SPFG,Felinfoel                       ,1626,795,20,109,831
49SPFH,Glanymor                        ,3621,1721,67,304,1900
49SPFJ,Glyn                            ,1620,794,20,92,826
49SPFK,Hendy                           ,2199,1192,17,95,1007
49SPFL,Hengoed                         ,2999,1498,54,163,1501
49SPFM,Kidwelly                        ,2596,1325,49,145,1271
49SPFN,Llangennech                     ,3199,1674,40,162,1525
49SPFP,Lliedi                          ,4374,1968,48,197,2406
49SPFQ,Llwynhendy                      ,3467,1650,47,237,1817
49SPFR,Pembrey                         ,2974,1465,43,171,1509
49SPFS,Pontyberem                      ,2239,1154,16,130,1085
49SPFT,Swiss Valley                    ,2128,1316,22,73,812
49SPFU,Trimsaran                       ,2097,1125,44,124,972
49SPFW,Tumble                          ,2928,1554,32,146,1374
49SPFX,Tycroes                         ,1722,999,18,88,723
49SPFY,Tyisha                          ,3495,1692,53,258,1803
49SPSS,Shipping                        ,0,0,0,0,0
49SQFA,Brawdy                          ,1155,793,47,50,362
49SQFB,Burton                          ,1105,607,11,44,498
49SQFC,Camrose                         ,1861,1082,25,58,779
49SQFD,Castle                          ,1581,945,28,122,636
49SQFE,Cilgerran                       ,1389,705,7,58,684
49SQFF,Clydey                          ,1084,619,16,38,465
49SQFG,Crymych                         ,1761,1044,18,72,717
49SQFH,Dinas Cross                     ,1325,727,17,54,598
49SQFJ,Fishguard                       ,2626,1231,23,102,1395
49SQFK,Garth                           ,3723,2078,77,251,1645
49SQFL,Goodwick                        ,1551,856,18,94,695
49SQFM,Hakin                           ,3919,2125,96,388,1794
49SQFN,Johnston                        ,1677,964,19,100,713
49SQFP,Letterston                      ,1564,953,26,47,611
49SQFQ,Llangwm                         ,1518,853,22,57,665
49SQFR,Maenclochog                     ,1286,744,16,40,542
49SQFS,Merlin's Bridge                 ,1429,864,16,102,565
49SQFT,Milford Central and East        ,3600,1893,58,284,1707
49SQFU,Milford North and West          ,3211,1799,66,287,1412
49SQFW,Newport                         ,979,390,8,37,589
49SQFX,Neyland East                    ,1451,818,30,116,633
49SQFY,Neyland West                    ,1688,933,40,152,755
49SQFZ,Prendergast                     ,1407,822,20,69,585
49SQGA,Priory                          ,1898,1210,23,103,688
49SQGB,Rudbaxton                       ,1664,1007,12,64,657
49SQGC,St.David's                      ,1615,893,6,63,722
49SQGD,St.Dogmaels                     ,1523,827,15,73,696
49SQGE,St.Ishmael's                    ,1182,693,8,62,489
49SQGF,Scleddau                        ,1097,636,18,39,461
49SQGG,Solva                           ,1424,767,22,49,657
49SQGH,The Havens                      ,1155,656,15,47,499
49SQGJ,Wiston                          ,1242,725,14,28,517
49SQSS,Shipping                        ,0,0,0,0,0
49SRFA,Amroth                          ,922,479,10,58,443
49SRFB,Begelly                         ,1426,753,15,101,673
49SRFC,Carew                           ,1026,587,11,40,439
49SRFD,East Williamston                ,1597,815,12,66,782
49SRFE,Hundleton                       ,1494,864,21,86,630
49SRFF,Lampeter Velfrey                ,1067,602,8,39,465
49SRFG,Lamphey                         ,1306,704,8,59,602
49SRFH,Manorbier                       ,1481,797,15,83,684
49SRFJ,Martletwy                       ,1020,549,9,30,471
49SRFK,Narberth Rural                  ,896,503,12,40,393
49SRFL,Narberth Urban                  ,1524,723,16,79,801
49SRFM,Pembroke Dock Central           ,1295,721,35,94,574
49SRFN,Pembroke Dock Llanion           ,1959,1073,51,195,886
49SRFP,Pembroke Dock Market            ,1398,795,29,113,603
49SRFQ,Pembroke Dock Pennar            ,2083,1259,54,182,824
49SRFR,Pembroke Monkton                ,1267,659,30,191,608
49SRFS,Pembroke St.Mary                ,2539,1323,36,195,1216
49SRFT,Pembroke St.Michael             ,1755,928,12,73,827
49SRFU,Penally                         ,1163,577,13,45,586
49SRFW,Saundersfoot                    ,2222,1166,23,135,1056
49SRFX,Stackpole                       ,0,0,0,0,0
49SRFY,Tenby                           ,3960,2047,33,234,1913
49SRSS,Shipping                        ,0,0,0,0,0
50SSFA,Abertillery                     ,3731,2016,31,233,1715
50SSFB,Badminton                       ,2648,1357,17,119,1291
50SSFC,Beaufort                        ,3128,1779,33,195,1349
50SSFD,Blaina                          ,3718,1830,43,198,1888
50SSFE,Brynmawr                        ,4441,2295,54,261,2146
50SSFF,Cwm                             ,3002,1524,44,176,1478
50SSFG,Cwmtillery                      ,3923,1904,64,274,2019
50SSFH,Ebbw Vale North                 ,3878,2071,65,282,1807
50SSFJ,Ebbw Vale South                 ,3394,1868,44,239,1526
50SSFK,Georgetown                      ,2679,1467,24,127,1212
50SSFL,Llanelly Hill                   ,3131,1774,23,145,1357
50SSFM,Llanhilleth                     ,4276,2078,62,296,2198
50SSFN,Nantyglo                        ,3733,1850,71,402,1883
50SSFP,Rassau                          ,2780,1602,41,202,1178
50SSFQ,Sirhowy                         ,4659,2434,64,301,2225
50SSFR,Six Bells                       ,2210,1172,27,153,1038
50SSFS,Tredegar Central and West       ,5186,2501,47,377,2685
50SSSS,Shipping                        ,0,0,0,0,0
50STFA,Abercarn                        ,3902,2093,43,184,1809
50STFB,Argoed                          ,2055,1066,22,186,989
50STFC,Blackwood                       ,5812,3255,50,284,2557
50STFD,Cefn Fforest                    ,2929,1613,38,201,1316
50STFE,Crosskeys                       ,2632,1361,20,88,1271
50STFF,Crumlin                         ,4758,2635,40,278,2123
50STFG,Newbridge                       ,5306,2858,55,278,2448
50STFH,Pengam                          ,2917,1548,34,169,1369
50STFJ,Penmaen                         ,3400,1899,27,150,1501
50STFK,Pontllanfraith                  ,6237,3392,71,364,2845
50STFL,Risca East                      ,5356,3573,49,303,1783
50STFM,Risca West                      ,4174,2191,50,164,1983
50STFN,Ynysddu                         ,3049,1899,35,200,1150
50STSS,Shipping                        ,0,0,0,0,0
50SUFA,Caerwent                        ,1890,1084,13,53,806
50SUFB,Caldicot Castle                 ,1833,1167,10,53,666
50SUFC,Cantref                         ,2493,1272,15,158,1221
50SUFD,Castle and Grofield             ,1760,1017,8,79,743
50SUFE,Croesonen                       ,1299,761,10,66,538
50SUFF,Crucorney                       ,1512,935,10,53,577
50SUFG,Dewstow                         ,1169,751,9,75,418
50SUFH,Goetre Fawr                     ,1884,1133,8,56,751
50SUFJ,Lansdown                        ,1412,652,13,74,760
50SUFK,Larkfield                       ,1195,704,4,42,491
50SUFL,Llanbadoc                       ,1058,664,10,36,394
50SUFM,Llanfoist Fawr                  ,1302,774,11,49,528
50SUFN,Llangybi Fawr                   ,1307,775,10,34,532
50SUFP,Llanover                        ,1810,1121,11,66,689
50SUFQ,Llantilio Crossenny             ,1272,823,3,35,449
50SUFR,Llanwenarth Ultra               ,1214,701,1,61,513
50SUFS,Magor with Undy                 ,3023,2067,21,71,956
50SUFT,Mardy                           ,1953,1114,19,114,839
50SUFU,Mitchel Troy                    ,981,606,10,26,375
50SUFW,Overmonnow                      ,1614,881,6,72,733
50SUFX,Portskewett                     ,1522,970,20,53,552
50SUFY,Priory                          ,2214,1099,12,64,1115
50SUFZ,Raglan                          ,1532,877,8,43,655
50SUGA,Rogiet                          ,862,503,4,47,359
50SUGB,St.Arvans                       ,1224,747,7,41,477
50SUGC,St.Christophers                 ,1524,999,14,54,525
50SUGD,St.Kingsmark                    ,1967,1210,14,49,757
50SUGE,St.Marys                        ,1372,877,6,66,495
50SUGF,Severn                          ,3412,2262,30,171,1150
50SUGG,Shirenewton                     ,1937,1196,15,58,741
50SUGH,Thornwell                       ,1590,1040,8,86,550
50SUGJ,Trellech United                 ,1906,1095,9,61,811
50SUGK,Usk                             ,1862,982,10,36,880
50SUGL,Vauxhall                        ,3294,1866,23,114,1428
50SUGM,West End                        ,1195,807,7,95,388
50SUGN,Wyesham                         ,1811,1034,21,82,777
50SUSS,Shipping                        ,0,0,0,0,0
50SWFA,Allt-yr-yn                      ,6821,3664,43,327,3157
50SWFB,Alway                           ,6405,3607,71,520,2798
50SWFC,Beechwood                       ,6446,3436,55,322,3010
50SWFD,Bettws                          ,6754,4200,80,699,2554
50SWFE,Caerleon                        ,6666,4147,41,242,2519
50SWFF,Gaer                            ,6999,3566,62,363,3433
50SWFG,Graig                           ,3553,2345,13,112,1208
50SWFH,Langstone                       ,2215,1287,17,68,928
50SWFJ,Liswerry                        ,7746,4865,65,442,2881
50SWFK,Llanwern                        ,2768,1789,25,166,979
50SWFL,Malpas                          ,6765,4158,56,313,2607
50SWFM,Marshfield                      ,2446,1549,12,95,897
50SWFN,Pillgwenlly                     ,4084,2008,51,580,2076
50SWFP,Ringland                        ,7110,3893,88,663,3217
50SWFQ,Rogerstone                      ,6078,3457,46,202,2621
50SWFR,St.Julians                      ,6782,4135,66,385,2647
50SWFS,Shaftesbury                     ,4310,2500,31,275,1810
50SWFT,Stow Hill                       ,3827,2322,56,352,1505
50SWFU,Tredegar Park                   ,1974,875,34,231,1099
50SWFW,Victoria                        ,4883,2844,65,385,2039
50SWSS,Shipping                        ,0,0,0,0,0
50SXFA,Abersychan                      ,5497,2956,80,377,2541
50SXFB,Blaenavon                       ,4955,2619,64,317,2336
50SXFC,Brynwern                        ,1500,790,15,97,710
50SXFD,Coed Eva                        ,1877,1299,22,109,578
50SXFE,Croesyceiliog North             ,3046,1685,32,110,1361
50SXFF,Croesyceiliog South             ,1639,791,11,35,848
50SXFG,Cwmyniscoy                      ,1233,691,20,96,542
50SXFH,Fairwater                       ,3780,2485,55,264,1295
50SXFJ,Greenmeadow                     ,3273,2171,51,265,1102
50SXFK,Llantarnam                      ,3681,1874,31,195,1807
50SXFL,Llanyrafon North                ,1729,905,13,52,824
50SXFM,Llanyrafon South                ,2054,978,7,44,1076
50SXFN,New Inn Lower                   ,2259,1224,16,73,1035
50SXFP,New Inn Upper                   ,2443,1529,13,44,914
50SXFQ,Panteg                          ,5604,3365,51,221,2239
50SXFR,Pontnewydd                      ,4764,2585,59,279,2179
50SXFS,Pontnewynydd                    ,1214,704,18,60,510
50SXFT,Pontypool                       ,1609,926,14,100,683
50SXFU,St.Cadocs and Penygarn          ,1319,658,22,107,661
50SXFW,St.Dials                        ,3319,1989,54,272,1330
50SXFX,Snatchwood                      ,1684,896,25,114,788
50SXFY,Trevethin                       ,2914,1621,68,321,1293
50SXFZ,Two Locks                       ,3725,2276,56,269,1449
50SXGA,Upper Cwmbran                   ,4419,2643,65,341,1776
50SXGB,Wainfelin                       ,1723,1010,18,90,713
50SXSS,Shipping                        ,0,0,0,0,0
51SYFA,Betws-y-Coed                    ,0,0,0,0,0
51SYFB,Bro Machno                      ,1603,956,8,69,647
51SYFC,Bryn                            ,1094,493,10,56,601
51SYFD,Bryn Rhys                       ,1811,1083,10,51,728
51SYFE,Caerhun                         ,1635,894,5,61,741
51SYFF,Capelulo                        ,1246,639,11,41,607
51SYFG,Conwy                           ,2925,1679,27,170,1246
51SYFH,Craig-y-Don                     ,2861,1430,14,121,1431
51SYFJ,Crwst                           ,1466,777,12,52,689
51SYFK,Deganwy                         ,3088,1305,7,102,1783
51SYFL,Eglwysbach                      ,1982,1209,26,50,773
51SYFM,Fforddlas                       ,0,0,0,0,0
51SYFN,Gogarth                         ,3194,1694,30,182,1500
51SYFP,Gower                           ,969,594,8,71,375
51SYFQ,Lafan                           ,0,0,0,0,0
51SYFR,Marl                            ,2927,1488,25,98,1439
51SYFS,Mostyn                          ,3060,1606,27,158,1454
51SYFT,Pandy                           ,1388,805,15,47,583
51SYFU,Pant-yr-afon                    ,1498,780,12,93,718
51SYFW,Penmaenan                       ,1240,692,30,83,548
51SYFX,Penrhyn                         ,3142,1355,14,60,1787
51SYFY,Pensarn                         ,2259,1445,21,95,814
51SYFZ,Trefriw                         ,1063,625,16,51,438
51SYGA,Tudno                           ,3429,1840,35,226,1589
51SYGB,Uwch Conwy                      ,0,0,0,0,0
51SYSS,Shipping                        ,0,0,0,0,0
51SZFA,Bethel                          ,1554,1006,16,67,548
51SZFB,Bontnewydd                      ,966,497,13,37,469
51SZFC,Cadnant                         ,1586,762,26,87,824
51SZFD,Deiniol                         ,0,0,0,0,0
51SZFE,Deiniolen                       ,1069,651,18,75,418
51SZFF,Dewi                            ,1246,736,23,65,510
51SZFG,Garth                           ,1405,714,24,109,691
51SZFH,Gerlan                          ,1003,591,18,88,412
51SZFJ,Glyder                          ,1318,712,9,60,606
51SZFK,Hendre                          ,982,534,20,76,448
51SZFL,Hirael                          ,1062,508,5,47,554
51SZFM,Llanberis                       ,1626,971,24,105,655
51SZFN,Llandwrog                       ,2015,1119,26,131,896
51SZFP,Llandygai                       ,1932,1100,24,105,832
51SZFQ,Llanllechid/Aber                ,828,501,9,23,327
51SZFR,Llanllyfni                      ,786,425,13,59,361
51SZFS,Llanrug                         ,2029,1186,21,124,843
51SZFT,Llanwnda                        ,1456,798,18,93,658
51SZFU,Marchog                         ,1923,1071,39,227,852
51SZFW,Menai (Bangor)                  ,1089,487,14,72,602
51SZFX,Menai (Caernarfon)              ,1898,1026,23,76,872
51SZFY,Ogwen                           ,2340,1358,26,175,982
51SZFZ,Peblig                          ,1777,902,38,270,875
51SZGA,Penisarwaun                     ,1080,629,20,91,451
51SZGB,Pentir                          ,1800,1111,21,67,689
51SZGC,Penygroes                       ,1458,781,22,108,677
51SZGD,Rachub                          ,0,0,0,0,0
51SZGE,Seiont                          ,2330,1403,20,156,927
51SZGF,Talysarn                        ,995,505,22,94,490
51SZGG,Waunfawr                        ,1246,696,15,74,550
51SZGH,Y Felinheli                     ,1501,902,24,92,599
51SZSS,Shipping                        ,0,0,0,0,0
51TAFA,Aberdaron                       ,0,0,0,0,0
51TAFB,Abererch                        ,1775,966,19,78,809
51TAFC,Abersoch                        ,0,0,0,0,0
51TAFD,Beddgelert                      ,0,0,0,0,0
51TAFE,Botwnnog                        ,1509,761,27,85,748
51TAFF,Buan                            ,0,0,0,0,0
51TAFG,Clynnog                         ,0,0,0,0,0
51TAFH,Criccieth                       ,1450,656,4,57,794
51TAFJ,Dolbenmaen                      ,1518,833,15,63,685
51TAFK,Efail-newydd                    ,0,0,0,0,0
51TAFL,Gest                            ,0,0,0,0,0
51TAFM,Llanaelhaearn                   ,1577,777,32,85,800
51TAFN,Llanarmon                       ,1729,1045,18,56,684
51TAFP,Llanbedrog                      ,913,359,8,40,554
51TAFQ,Llanengan                       ,1706,803,20,71,903
51TAFR,Llanystumdwy                    ,0,0,0,0,0
51TAFS,Nefyn                           ,2515,1177,33,139,1338
51TAFT,Pistyll                         ,0,0,0,0,0
51TAFU,Porthmadog East                 ,0,0,0,0,0
51TAFW,Porthmadog West                 ,1401,703,6,40,698
51TAFX,Pwllheli North                  ,1659,884,15,78,775
51TAFY,Pwllheli South                  ,1609,915,21,147,694
51TAFZ,Tremadog                        ,1892,1125,26,102,767
51TAGA,Tudweiliog                      ,1105,582,15,36,523
51TASS,Shipping                        ,0,0,0,0,0
51TBFA,Aberdovey                       ,0,0,0,0,0
51TBFB,Arthog                          ,0,0,0,0,0
51TBFC,Bala                            ,1578,814,13,81,764
51TBFD,Barmouth                        ,1865,1041,25,151,824
51TBFE,Bowydd and Rhiw                 ,1615,936,25,111,679
51TBFF,Brithdir and Llanfachreth       ,0,0,0,0,0
51TBFG,Bryn-crug                       ,0,0,0,0,0
51TBFH,Conglywal and Maenofferen       ,2583,1430,38,127,1153
51TBFJ,Corris                          ,1098,610,9,59,488
51TBFK,Cynfal and Teigl                ,0,0,0,0,0
51TBFL,Dolgellau                       ,2937,1592,26,133,1345
51TBFM,Dyffryn Ardudwy                 ,1240,613,6,60,627
51TBFN,Harlech                         ,1559,839,10,81,720
51TBFP,Llanbedr                        ,927,483,3,36,444
51TBFQ,Llandderfel                     ,1205,717,9,44,488
51TBFR,Llanelltyd                      ,1150,630,14,42,520
51TBFS,Llangelynin                     ,1292,667,6,35,625
51TBFT,Llanuwchllyn                    ,0,0,0,0,0
51TBFU,Mawddwy                         ,1204,659,12,41,545
51TBFW,Penrhyndeudraeth                ,1931,1064,9,69,867
51TBFX,Trawsfynydd                     ,1243,752,19,66,491
51TBFY,Tywyn                           ,3332,1687,26,122,1645
51TBSS,Shipping                        ,0,0,0,0,0
51TCFA,Aberffraw                       ,2060,1070,26,152,990
51TCFB,Amlwch                          ,3090,1549,52,255,1541
51TCFC,Beaumaris                       ,1701,802,17,90,899
51TCFD,Bodffordd                       ,1224,712,26,61,512
51TCFE,Bodorgan                        ,1234,674,30,83,560
51TCFF,Bryngwran                       ,1445,794,22,109,651
51TCFG,Brynteg                         ,1543,697,18,72,846
51TCFH,Cadnant                         ,909,474,13,58,435
51TCFJ,Cefni                           ,1182,648,10,22,534
51TCFK,Cwm Cadnant                     ,1859,1106,24,66,753
51TCFL,Cyngar                          ,1209,679,13,61,530
51TCFM,Holyhead Town                   ,928,549,23,110,379
51TCFN,Kingsland                       ,1135,633,20,99,502
51TCFP,Llanbadrig                      ,1143,572,17,74,571
51TCFQ,Llanbedrgoch                    ,1325,599,11,70,726
51TCFR,Llanddyfnan                     ,1053,637,8,47,416
51TCFS,Llaneilian                      ,1808,917,37,108,891
51TCFT,Llanfaethlu                     ,1273,711,17,85,562
51TCFU,Llanfair Pwllgwyngyll           ,2407,1441,25,75,966
51TCFW,Llanfair-yn-Neubwll             ,2069,1401,32,105,668
51TCFX,Llanfihangel Ysgeifiog          ,1592,986,16,71,606
51TCFY,Llangoed                        ,1072,528,14,56,544
51TCFZ,Llanidan                        ,1292,743,14,80,549
51TCGA,Llanmerch-y-Medd                ,1363,768,22,86,595
51TCGB,London Road                     ,1352,720,34,107,632
51TCGC,Maeshyfryd                      ,1651,914,50,170,737
51TCGD,Mechell                         ,1226,642,19,71,584
51TCGE,Moelfre                         ,948,439,8,64,509
51TCGF,Morawelon                       ,1265,683,40,133,582
51TCGG,Parca'r Mynydd                  ,998,564,18,70,434
51TCGH,Pentraeth                       ,1446,779,16,81,667
51TCGJ,Porthyfelin                     ,1888,967,38,184,921
51TCGK,Rhosyr                          ,1717,893,18,135,824
51TCGL,Trearddur                       ,1900,973,22,77,927
51TCGM,Tudur                           ,1231,697,30,100,534
51TCGN,Tysilio                         ,1620,937,15,78,683
51TCGP,Valley                          ,1839,1010,27,107,829
51TCSS,Shipping                        ,0,0,0,0,0
52TDFA,Aberaman North                  ,4207,2138,44,252,2069
52TDFB,Aberaman South                  ,3928,1977,65,348,1951
52TDFC,Abercynon                       ,5085,2773,68,460,2312
52TDFD,Aberdare East                   ,5366,2629,64,284,2737
52TDFE,Aberdare West                   ,5708,3049,49,274,2659
52TDFF,Cwmbach                         ,3792,1979,63,292,1813
52TDFG,Hirwaun                         ,3216,1686,31,198,1530
52TDFH,Llwydcoed                       ,1159,610,14,58,549
52TDFJ,Mountain Ash East               ,2406,1221,23,171,1185
52TDFK,Mountain Ash West               ,3762,1845,65,358,1917
52TDFL,Penrhiwceiber                   ,5193,2710,105,589,2483
52TDFM,Pen-y-waun                      ,2687,1230,58,335,1457
52TDFN,Rhigos                          ,1445,795,26,84,650
52TDFP,Ynysybwl                        ,3467,1908,34,212,1559
52TDSS,Shipping                        ,0,0,0,0,0
52TEFA,Bedlinog                        ,2835,1392,28,241,1443
52TEFB,Cyfarthfa                       ,5039,2738,64,374,2301
52TEFC,Dowlais                         ,5708,2954,59,477,2754
52TEFD,Gurnos                          ,4660,2128,88,509,2532
52TEFE,Merthyr Vale                    ,3328,1642,34,282,1686
52TEFF,Park                            ,3422,1808,40,210,1614
52TEFG,Penydarren                      ,4174,2050,45,319,2124
52TEFH,Plymouth                        ,4179,2221,44,259,1958
52TEFJ,Town                            ,5487,2833,50,303,2654
52TEFK,Treharris                       ,4661,2547,56,304,2114
52TEFL,Vaynor                          ,2744,1472,28,183,1272
52TESS,Shipping                        ,0,0,0,0,0
52TFFA,Bettws                          ,2068,1015,11,218,1053
52TFFB,Blackmill                       ,2189,1124,21,229,1065
52TFFC,Blaengarw                       ,1491,790,13,107,701
52TFFD,Brackla                         ,5850,4402,22,265,1448
52TFFE,Caerau                          ,3612,1754,22,359,1858
52TFFF,Cefn Cribwr                     ,1352,794,17,70,558
52TFFG,Coity Higher                    ,4222,2439,24,157,1783
52TFFH,Cornelly                        ,5007,2752,40,383,2255
52TFFJ,Coychurch Lower                 ,2193,1264,6,75,929
52TFFK,Laleston                        ,5573,3469,39,330,2104
52TFFL,Llangeinor                      ,1153,610,16,108,543
52TFFM,Llangynwyd                      ,1901,1103,15,78,798
52TFFN,Maesteg East                    ,4301,2285,38,206,2016
52TFFP,Maesteg West                    ,4909,2692,35,362,2217
52TFFQ,Morfa                           ,3913,2140,39,301,1773
52TFFR,Nantyffyllon                    ,2747,1480,22,196,1267
52TFFS,Nant-y-Moel                     ,1952,999,10,156,953
52TFFT,Newcastle                       ,4488,2377,25,225,2111
52TFFU,Newcastle Higher                ,3390,1924,22,111,1466
52TFFW,Ogmore Vale                     ,2586,1360,17,134,1226
52TFFX,Oldcastle                       ,3450,1790,8,196,1660
52TFFY,Pencoed                         ,7236,4513,50,400,2723
52TFFZ,Pontycymmer                     ,2043,1110,26,119,933
52TFGA,Porthcawl East                  ,5771,2869,38,345,2902
52TFGB,Porthcawl West                  ,7886,3820,29,311,4066
52TFGC,Pyle                            ,5178,2757,37,360,2421
52TFGD,St Bride's Major                ,2574,1462,11,109,1112
52TFGE,St Bride's Minor                ,4467,2711,30,308,1756
52TFGF,Ynysawdre                       ,2068,1073,11,110,995
52TFSS,Shipping                        ,0,0,0,0,0
52TGFA,Cwm Clydach                     ,2586,1282,23,242,1304
52TGFB,Cymmer                          ,5051,2590,49,440,2461
52TGFC,Ferndale                        ,3785,1877,35,275,1908
52TGFD,Llwyn-y-pia                     ,2006,904,21,154,1102
52TGFE,Maerdy                          ,3201,1465,58,358,1736
52TGFF,Pentre                          ,4414,2212,39,276,2202
52TGFG,Pen-y-graig                     ,4727,2372,44,348,2355
52TGFH,Porth                           ,4899,2660,51,348,2239
52TGFJ,Trealaw                         ,3458,1610,32,237,1848
52TGFK,Treherbert                      ,5431,2484,81,478,2947
52TGFL,Treorchy                        ,6436,3126,61,393,3310
52TGFM,Tonypandy                       ,2893,1539,34,147,1354
52TGFN,Tylorstown                      ,5118,2413,88,675,2705
52TGFP,Ynyshir                         ,3016,1426,32,216,1590
52TGFQ,Ystrad                          ,5160,2546,43,361,2614
52TGSS,Shipping                        ,0,0,0,0,0
52THFA,Aberbargoed                     ,2990,1356,48,255,1634
52THFB,Abertysswg                      ,1163,579,8,104,584
52THFC,Aber Valley                     ,5069,2865,57,472,2204
52THFD,Bargoed                         ,5270,2653,53,429,2617
52THFE,Bedwas and Trethomas            ,4927,2731,51,281,2196
52THFF,Darran Valley                   ,2109,1069,40,177,1040
52THFG,Gilfach                         ,1819,902,16,121,917
52THFH,Hengoed                         ,3625,1999,47,309,1626
52THFJ,Llanbradach                     ,3590,2287,31,244,1303
52THFK,Machen                          ,3032,1734,29,226,1298
52THFL,Maesycwmmer                     ,1827,1003,10,123,824
52THFM,Morgan Jones                    ,4743,2803,56,292,1940
52THFN,Moriah                          ,2585,1250,28,209,1335
52THFP,Nelson                          ,3391,1918,41,224,1473
52THFQ,New Tredegar                    ,3084,1467,29,278,1617
52THFR,Penyrheol                       ,7637,4504,55,528,3133
52THFS,Pontlottyn                      ,1621,820,23,128,801
52THFT,St.Cattwg                       ,5271,2822,56,395,2449
52THFU,St. James                       ,4911,2842,53,455,2069
52THFW,St. Martins                     ,4926,2877,31,206,2049
52THFX,Tir-Phil                        ,1090,505,8,71,585
52THFY,Twyn Carno                      ,2122,1077,23,267,1045
52THFZ,Ystrad Mynach                   ,2980,1621,17,140,1359
52THSS,Shipping                        ,0,0,0,0,0
52TJFA,Beddau                          ,2474,1767,22,127,707
52TJFB,Brynna                          ,2635,1783,23,129,852
52TJFC,Church Village                  ,2273,1331,22,133,942
52TJFD,Cilfynydd                       ,2228,1317,20,161,911
52TJFE,Creigiau                        ,2064,1431,7,51,633
52TJFF,Gilfach Goch                    ,2693,1428,25,260,1265
52TJFG,Glyncoch                        ,2337,1206,36,267,1131
52TJFH,Graig                           ,1933,1057,7,116,876
52TJFJ,Hawthorn                        ,1847,976,13,84,871
52TJFK,Ilan                            ,1292,722,24,216,570
52TJFL,Llanharan                       ,2210,1437,16,109,773
52TJFM,Llanharry                       ,1828,1039,19,145,789
52TJFN,Llantrisant Town                ,3111,2026,21,118,1085
52TJFP,Llantwit Fardre                 ,4086,3012,27,116,1074
52TJFQ,Pentyrch                        ,2724,1830,14,118,894
52TJFR,Pont-y-Clun                     ,3527,2116,11,115,1411
52TJFS,Pontypridd Town                 ,2457,1592,12,95,865
52TJFT,Rhondda                         ,3632,2005,27,200,1627
52TJFU,Rhydfelen Central               ,2226,1046,30,152,1180
52TJFW,Rhydfelen Lower                 ,1291,605,9,73,686
52TJFX,Taffs Well                      ,2816,1797,19,141,1019
52TJFY,Talbot Green                    ,2016,1031,11,72,985
52TJFZ,Ton-teg                         ,3897,2522,19,102,1375
52TJGA,Tonyrefail East                 ,4769,2668,35,346,2101
52TJGB,Tonyrefail West                 ,3535,1838,30,214,1697
52TJGC,Trallwng                        ,3100,1739,19,132,1361
52TJGD,Treforest                       ,2926,1566,30,198,1360
52TJGE,Tyn-y-nant                      ,2836,1778,28,227,1058
52TJSS,Shipping                        ,0,0,0,0,0
53TKFA,Aber-Craf                       ,1191,602,9,70,589
53TKFB,Bronllys                        ,0,0,0,0,0
53TKFC,Builth                          ,1669,946,9,48,723
53TKFD,Bwlch                           ,0,0,0,0,0
53TKFE,Crickhowell                     ,1713,988,4,56,725
53TKFF,Cwm-twrch                       ,1574,757,20,99,817
53TKFG,Erwood                          ,0,0,0,0,0
53TKFH,Felin-fach                      ,1649,1062,13,34,587
53TKFJ,Gwernyfed                       ,1090,728,11,40,362
53TKFK,Hay                             ,1160,695,9,57,465
53TKFL,Llanafanfawr                    ,1431,816,16,23,615
53TKFM,Llanfrynach                     ,1465,831,10,39,634
53TKFN,Llangamarch                     ,0,0,0,0,0
53TKFP,Llangattock                     ,1677,893,13,56,784
53TKFQ,Llangors                        ,834,512,4,26,322
53TKFR,Llangynidr                      ,0,0,0,0,0
53TKFS,Llanwrtyd Wells                 ,1269,729,3,34,540
53TKFT,Llywel                          ,0,0,0,0,0
53TKFU,Maescar                         ,1298,789,5,34,509
53TKFW,St.David Within                 ,1195,650,4,39,545
53TKFX,St.John                         ,2522,1446,17,100,1076
53TKFY,St.Mary                         ,2303,1426,15,67,877
53TKFZ,Talgarth                        ,2260,1267,11,58,993
53TKGA,Talybont-on-Usk                 ,0,0,0,0,0
53TKGB,Tawe-Uchaf                      ,1782,888,11,85,894
53TKGC,The Vale of Grwyney             ,1250,728,7,37,522
53TKGD,Ynyscedwyn                      ,1742,843,16,62,899
53TKGE,Yscir                           ,0,0,0,0,0
53TKGF,Ystradfellte                    ,0,0,0,0,0
53TKGG,Ystradgynlais                   ,2194,1077,31,128,1117
53TKSS,Shipping                        ,0,0,0,0,0
53TLFA,Banwy                           ,0,0,0,0,0
53TLFB,Berriew                         ,1075,626,14,37,449
53TLFC,Cadfarch                        ,0,0,0,0,0
53TLFD,Caersws                         ,1228,736,9,25,492
53TLFE,Carno                           ,0,0,0,0,0
53TLFF,Churchstoke                     ,1128,655,13,28,473
53TLFG,Dolforwyn                       ,1097,707,7,21,390
53TLFH,Forden                          ,1683,1035,10,46,648
53TLFJ,Glantwymyn                      ,1515,820,5,36,695
53TLFK,Guilsfield Within               ,858,484,7,20,374
53TLFL,Guilsfield Without              ,0,0,0,0,0
53TLFM,Kerry                           ,1337,804,8,25,533
53TLFN,Llanbrynmair                    ,1199,704,3,43,495
53TLFP,Llandinam                       ,0,0,0,0,0
53TLFQ,Llandrinio                      ,2076,1244,13,55,832
53TLFR,Llandysilio                     ,0,0,0,0,0
53TLFS,Llanfair Caereinion             ,1879,1121,15,47,758
53TLFT,Llanfihangel                    ,0,0,0,0,0
53TLFU,Llanfyllin                      ,1036,593,15,37,443
53TLFW,Llangurig                       ,0,0,0,0,0
53TLFX,Llanidloes East                 ,2201,1266,14,95,935
53TLFY,Llanidloes West                 ,0,0,0,0,0
53TLFZ,Llansantffraid                  ,1281,662,6,41,619
53TLGA,Llanwddyn                       ,1772,991,20,45,781
53TLGB,Machynlleth No.1                ,0,0,0,0,0
53TLGC,Machynlleth No.2                ,1650,919,16,70,731
53TLGD,Meifod                          ,1580,965,15,28,615
53TLGE,Mochdre                         ,1380,879,13,31,501
53TLGF,Montgomery                      ,908,585,10,25,323
53TLGG,Newtown Central                 ,2256,1511,25,155,745
53TLGH,Newtown East                    ,1536,1041,17,106,495
53TLGJ,Newtown Llanllwchaiarn North    ,1462,851,4,30,611
53TLGK,Newtown Llanllwchaiarn West     ,1392,857,21,49,535
53TLGL,Newtown South                   ,1515,975,21,145,540
53TLGM,Rhiewcynon                      ,973,610,7,23,363
53TLGN,Trefeglwys                      ,1590,980,9,42,610
53TLGP,Trewern                         ,0,0,0,0,0
53TLGQ,Welshpool Castle                ,1235,679,13,75,556
53TLGR,Welshpool Gungrog               ,1821,1098,14,83,723
53TLGS,Welshpool Llanerchyddol         ,1741,1075,12,52,666
53TLSS,Shipping                        ,0,0,0,0,0
53TMFA,Beguildy                        ,0,0,0,0,0
53TMFB,Clyro                           ,0,0,0,0,0
53TMFC,Disserth and Trecoed            ,853,422,8,31,431
53TMFD,Gladestry                       ,869,517,7,19,352
53TMFE,Glasbury                        ,0,0,0,0,0
53TMFF,Glascwm                         ,0,0,0,0,0
53TMFG,Knighton                        ,2325,1432,15,71,893
53TMFH,Llanbadarn Fawr                 ,0,0,0,0,0
53TMFJ,Llanbister                      ,0,0,0,0,0
53TMFK,Llandrindod East                ,0,0,0,0,0
53TMFL,Llandrindod North               ,1409,905,14,55,504
53TMFM,Llandrindod South No.1          ,0,0,0,0,0
53TMFN,Llandrindod South No.2          ,1488,800,17,63,688
53TMFP,Llandrindod West                ,1142,619,13,38,523
53TMFQ,Llanelwedd                      ,972,591,10,41,381
53TMFR,Llanfihangel Rhydithon          ,929,571,6,31,358
53TMFS,Llangunllo                      ,1079,633,4,46,446
53TMFT,Llansantffraed-Cwmdeuddwr       ,0,0,0,0,0
53TMFU,Llanyre                         ,865,500,4,23,365
53TMFW,Nantmel                         ,1202,700,8,22,502
53TMFX,New Radnor                      ,0,0,0,0,0
53TMFY,Old Radnor                      ,952,549,8,24,403
53TMFZ,Painscastle                     ,1057,639,4,22,418
53TMGA,Presteigne                      ,1759,902,8,39,857
53TMGB,Rhayader Town                   ,1329,690,9,42,639
53TMGC,St.Harmon                       ,951,582,6,28,369
53TMSS,Shipping                        ,0,0,0,0,0
54TNFA,Adamsdown                       ,5927,3495,85,677,2432
54TNFB,Butetown                        ,2811,1477,47,371,1334
54TNFC,Caerau                          ,7966,4368,80,666,3598
54TNFD,Canton                          ,10789,6616,97,615,4173
54TNFE,Cathays                         ,8389,4897,80,572,3492
54TNFF,Cyncoed                         ,8625,4727,42,227,3898
54TNFG,Ely                             ,11244,5989,131,1094,5255
54TNFH,Fairwater                       ,10412,6254,79,697,4158
54TNFJ,Gabalfa                         ,4421,2694,43,280,1727
54TNFK,Grangetown                      ,9785,5608,117,936,4177
54TNFL,Heath                           ,9373,5308,51,265,4065
54TNFM,Lisvane and St Mellons          ,4802,3196,13,124,1606
54TNFN,Llandaff                        ,6791,4180,47,196,2611
54TNFP,Llandaff North                  ,6300,3498,56,408,2802
54TNFQ,Llanishen                       ,11101,6773,68,405,4328
54TNFR,Llanrumney                      ,9451,4993,102,775,4458
54TNFS,Pentwyn                         ,12138,8620,146,934,3518
54TNFT,Plasnewydd                      ,11784,7151,130,1011,4633
54TNFU,Radyr and St.Fagans             ,4016,2462,15,101,1554
54TNFW,Rhiwbina                        ,9515,5039,24,195,4476
54TNFX,Riverside                       ,9706,5534,154,949,4172
54TNFY,Roath                           ,8593,5005,56,336,3588
54TNFZ,Rumney                          ,6990,3952,46,405,3038
54TNGA,Splott                          ,8222,4582,87,689,3640
54TNGB,Trowbridge                      ,9068,5663,74,735,3405
54TNGC,Whitchurch and Tongwynlais      ,12078,6726,70,446,5352
54TNSS,Shipping                        ,0,0,0,0,0
54TPFA,Alexandra                       ,9055,4872,52,456,4183
54TPFB,Baruc                           ,4539,2406,27,240,2133
54TPFC,Buttrills                       ,4465,2344,50,264,2121
54TPFD,Cadoc                           ,5808,3715,75,447,2093
54TPFE,Castleland                      ,3004,1799,36,285,1205
54TPFF,Cornerswell                     ,4331,2623,28,187,1708
54TPFG,Court                           ,3985,2366,50,324,1619
54TPFH,Cowbridge                       ,5012,2864,19,121,2148
54TPFJ,Dinas Powys                     ,7450,4652,44,290,2798
54TPFK,Dyfan                           ,4111,2320,30,198,1791
54TPFL,Gibbonsdown                     ,4105,2198,63,354,1907
54TPFM,Illtyd                          ,5938,3619,52,303,2319
54TPFN,Llandough                       ,1636,1075,6,52,561
54TPFP,Llandow                         ,1478,939,4,37,539
54TPFQ,Llantwit Major                  ,7585,4712,61,317,2873
54TPFR,Peterston-super-Ely             ,2200,1164,12,63,1036
54TPFS,Rhoose                          ,3528,2146,27,121,1382
54TPFT,St. Athan                       ,2926,2105,33,144,821
54TPFU,Stanwell                        ,3089,1542,15,134,1547
54TPFW,Sully                           ,3388,2116,4,94,1272
54TPFX,Wenvoe                          ,1885,1134,2,37,751
54TPSS,SHIPPING                        ,0,0,0,0,0
55TQFA,Allt-Wen                        ,1799,1049,12,85,750
55TQFB,Clydach                         ,2372,1206,14,73,1166
55TQFC,Cwmllynfell                     ,961,490,11,54,471
55TQFD,Dulais East                     ,1226,629,17,89,597
55TQFE,Godre'r graig                   ,1200,645,19,62,555
55TQFF,Gorseinon Central               ,1258,592,16,54,666
55TQFG,Gorseinon East                  ,1163,592,17,77,571
55TQFH,Gowerton East                   ,1601,1002,18,57,599
55TQFJ,Gowerton West                   ,1493,849,24,63,644
55TQFK,Graigfelen                      ,1344,752,21,131,592
55TQFL,Gwaun-Cae-Gurwen                ,2291,1082,32,132,1209
55TQFM,Kingsbridge                     ,3297,2057,29,102,1240
55TQFN,Llangyfelach                    ,2485,1632,16,75,853
55TQFP,Lower Brynamman                 ,1143,574,31,70,569
55TQFQ,Lower Loughor                   ,1700,972,22,98,728
55TQFR,Mawr                            ,1553,850,18,81,703
55TQFS,Penllergaer                     ,1803,923,24,81,880
55TQFT,Penyrheol                       ,4081,2296,38,207,1785
55TQFU,Pontardawe                      ,4126,2165,53,212,1961
55TQFW,Pontardulais                    ,1371,719,5,58,652
55TQFX,Rhos                            ,1928,1119,15,66,809
55TQFY,Tal-y-bont                      ,1598,856,8,76,742
55TQFZ,Trebanos                        ,1175,609,12,64,566
55TQGA,Upper Loughor                   ,2311,1289,26,90,1022
55TQGB,Vardre                          ,2032,1136,26,103,896
55TQGC,Ystalyfera                      ,2684,1272,29,162,1412
55TQSS,Shipping                        ,0,0,0,0,0
55TRFA,Aberdulais                      ,1526,873,20,107,653
55TRFB,Blaengwrach                     ,1705,826,23,87,879
55TRFC,Briton Ferry East               ,2624,1367,26,132,1257
55TRFD,Briton Ferry West               ,2537,1250,55,195,1287
55TRFE,Bryn-coch North                 ,2017,1173,13,78,844
55TRFF,Bryn-coch South                 ,2918,1529,24,121,1389
55TRFG,Cadoxton                        ,1181,669,6,47,512
55TRFH,Cimla                           ,3386,2306,34,138,1080
55TRFJ,Coedffranc Central              ,3266,1669,42,181,1597
55TRFK,Coedffranc North                ,1849,1021,17,100,828
55TRFL,Coedffranc West                 ,1670,923,18,63,747
55TRFM,Crynant                         ,1666,815,22,77,851
55TRFN,Dyffryn                         ,2501,1369,34,127,1132
55TRFP,Glynneath                       ,3087,1520,22,159,1567
55TRFQ,Neath East                      ,5020,2554,68,299,2466
55TRFR,Neath North                     ,3366,1611,41,172,1755
55TRFS,Neath South                     ,3813,1836,48,260,1977
55TRFT,Onllwyn                         ,1038,467,16,70,571
55TRFU,Pelenna                         ,1077,574,13,75,503
55TRFW,Resolven                        ,2699,1465,38,128,1234
55TRFX,Seven Sisters                   ,1847,913,22,155,934
55TRFY,Tonna                           ,1728,925,21,62,803
55TRSS,Shipping                        ,0,0,0,0,0
55TSFA,Aberavon                        ,4573,2598,54,305,1975
55TSFB,Baglan                          ,5781,3229,47,237,2552
55TSFC,Bryn and Cwmavon                ,5001,2523,49,255,2478
55TSFD,Cymmer                          ,2597,1073,36,183,1524
55TSFE,Glyncorrwg                      ,1000,468,22,86,532
55TSFF,Gwynfi                          ,1338,617,27,121,721
55TSFG,Margam                          ,1419,733,13,66,686
55TSFH,Port Talbot                     ,4494,2436,36,207,2058
55TSFJ,Sandfields East                 ,5103,2181,31,263,2922
55TSFK,Sandfields West                 ,5546,2534,64,406,3012
55TSFL,Tai Bach                        ,3972,2148,27,188,1824
55TSSS,Shipping                        ,0,0,0,0,0
55TTFA,Bishopston                      ,3957,2133,21,120,1824
55TTFB,Bonymaen                        ,5584,3097,104,493,2487
55TTFC,Castle                          ,9796,4945,107,819,4851
55TTFD,Cockett                         ,10408,5751,100,584,4657
55TTFE,Cwmbwrla                        ,6507,3687,63,313,2820
55TTFF,Dunvant                         ,3883,2476,25,137,1407
55TTFG,Killay                          ,3491,1891,16,102,1600
55TTFH,Landore                         ,5156,3012,57,377,2144
55TTFJ,Llansamlet                      ,8029,4758,126,454,3271
55TTFK,Mayals                          ,2215,1147,4,56,1068
55TTFL,Morriston                       ,13082,7920,173,695,5162
55TTFM,Mynyddbach                      ,8116,4712,117,503,3404
55TTFN,Newton                          ,2966,1540,13,86,1426
55TTFP,North Gower                     ,5282,2914,40,205,2368
55TTFQ,Oystermouth                     ,3568,1778,31,167,1790
55TTFR,Penderry                        ,9067,4332,153,1098,4735
55TTFS,Pennard                         ,2387,1249,23,80,1138
55TTFT,St.Thomas                       ,5547,3097,60,343,2450
55TTFU,Sketty                          ,11163,5466,75,354,5697
55TTFW,South Gower                     ,1882,991,7,46,891
55TTFX,Townhill                        ,7327,3395,177,961,3932
55TTFY,Uplands                         ,10487,5578,122,757,4909
55TTFZ,West Cross                      ,5739,2612,35,219,3127
55TTSS,Shipping                        ,0,0,0,0,0
5601AB,TD3 6                           ,0,0,0,0,0
5601AD,TD5 7                           ,812,530,6,22,282
5601AE,TD106                           ,823,531,4,33,292
5601AF,TD113                           ,5279,3117,30,141,2162
5601AG,TD124                           ,2211,1232,17,71,979
5601AH,TD135                           ,0,0,0,0,0
5601AJ,TD145                           ,5459,3085,34,259,2374
5601AK,TD151                           ,852,522,9,33,330
5602AB,EH385                           ,0,0,0,0,0
5602AE,TD1 1                           ,4182,2732,29,153,1450
5602AF,TD1 2                           ,4867,3337,51,269,1530
5602AG,TD1 3                           ,3728,2255,18,100,1473
5602AH,TD2 6                           ,1711,1148,12,48,563
5602AJ,TD3 6                           ,0,0,0,0,0
5602AK,TD4 6                           ,1625,1069,14,50,556
5602AM,TD5 8                           ,0,0,0,0,0
5602AN,TD6 9                           ,3089,1633,15,48,1456
5602AP,TD6 0                           ,2458,1488,21,89,970
5602AQ,TD7 4                           ,3779,2398,18,85,1381
5602AR,TD7 5                           ,2165,1419,14,70,746
5603AC,TD5 7                           ,4974,3124,30,124,1850
5603AD,TD5 8                           ,2806,1747,17,106,1059
5603AE,TD6 9                           ,0,0,0,0,0
5603AF,TD8 6                           ,4875,3080,32,189,1795
5603AG,TD9 7                           ,3597,2280,35,123,1317
5603AH,TD9 8                           ,4601,2882,69,305,1719
5603AJ,TD9 9                           ,3977,2662,22,154,1315
5603AK,TD9 0                           ,4010,2253,34,115,1757
5604AB,EH269                           ,0,0,0,0,0
5604AC,EH436                           ,0,0,0,0,0
5604AD,EH446                           ,2912,1781,16,160,1131
5604AE,EH458                           ,4106,2396,29,158,1710
5604AF,EH459                           ,2691,1647,15,76,1044
5604AG,EH467                           ,2676,1647,15,80,1029
5604AH,ML126                           ,0,0,0,0,0
5705AC,FK101                           ,3824,2361,67,420,1463
5705AD,FK102                           ,10421,6104,131,642,4317
5705AE,FK103                           ,6932,3822,83,456,3110
5705AF,FK104                           ,2743,1700,36,174,1043
5705AG,FK117                           ,1844,1152,14,76,692
5705AH,FK125                           ,4099,2602,53,222,1497
5705AJ,FK136                           ,4886,2958,62,242,1928
5705AK,FK147                           ,2837,1687,24,109,1150
5705AL,KY137                           ,0,0,0,0,0
5706AA,EH496                           ,0,0,0,0,0
5706AB,EH497                           ,1112,695,14,79,417
5706AC,EH519                           ,6054,3754,65,425,2300
5706AD,EH510                           ,5666,3542,63,357,2124
5706AE,FK1 1                           ,2820,1239,5,121,1581
5706AF,FK1 2                           ,5952,3963,67,468,1989
5706AG,FK1 3                           ,1564,906,23,134,658
5706AH,FK1 4                           ,6448,3972,91,611,2476
5706AJ,FK1 5                           ,6201,3528,41,199,2673
5706AK,FK2 7                           ,7168,4251,85,694,2917
5706AL,FK2 8                           ,4802,3179,51,269,1623
5706AM,FK2 9                           ,8379,4970,99,690,3409
5706AN,FK2 0                           ,9588,6375,72,420,3213
5706AP,FK3 8                           ,6700,3603,83,399,3097
5706AQ,FK3 9                           ,4172,2603,53,237,1569
5706AR,FK3 0                           ,4601,3029,82,416,1572
5706AS,FK4 1                           ,6711,4127,75,412,2584
5706AT,FK4 2                           ,1558,948,31,117,610
5706AU,FK5 3                           ,3725,2244,27,205,1481
5706AW,FK5 4                           ,9421,5439,57,343,3982
5706AX,FK6 5                           ,6027,4233,75,378,1794
5706AY,FK6 6                           ,4336,2510,47,350,1826
5706AZ,FK7 7                           ,0,0,0,0,0
5707AA,FK2 8                           ,0,0,0,0,0
5707AC,FK6 5                           ,0,0,0,0,0
5707AD,FK6 6                           ,0,0,0,0,0
5707AE,FK7 7                           ,6921,4404,104,485,2517
5707AF,FK7 8                           ,3881,2423,47,227,1458
5707AG,FK7 9                           ,5546,3434,51,310,2112
5707AH,FK7 0                           ,5612,3078,76,328,2534
5707AJ,FK8 1                           ,6105,3455,95,604,2650
5707AK,FK8 2                           ,2785,1616,12,80,1169
5707AL,FK8 3                           ,4374,2674,24,135,1700
5707AM,FK9 4                           ,4438,2551,34,141,1887
5707AN,FK9 5                           ,4082,2458,48,218,1624
5707AP,FK159                           ,3703,2328,23,128,1375
5707AQ,FK150                           ,2667,1606,19,89,1061
5707AR,FK166                           ,1528,945,11,67,583
5707AS,FK178                           ,2624,1518,21,63,1106
5707AT,FK188                           ,0,0,0,0,0
5707AU,FK198                           ,0,0,0,0,0
5707AW,FK208                           ,0,0,0,0,0
5707AX,FK218                           ,1502,921,4,55,581
5707AY,G62 8                           ,0,0,0,0,0
5707AZ,G63 9                           ,3489,2129,9,89,1360
5707BA,G63 0                           ,3759,2202,27,94,1557
5707BC,G83 8                           ,0,0,0,0,0
5808AA,CA6 5                           ,2776,1840,22,132,936
5808AC,DG1 4                           ,0,0,0,0,0
5808AD,DG109                           ,2933,1674,10,109,1259
5808AE,DG111                           ,3655,2251,32,104,1404
5808AF,DG112                           ,4047,2430,27,124,1617
5808AG,DG113                           ,2566,1645,27,91,921
5808AH,DG125                           ,4708,2782,30,189,1926
5808AJ,DG126                           ,5372,3429,40,251,1943
5808AK,DG130                           ,2737,1778,8,101,959
5808AL,DG140                           ,1067,648,9,20,419
5809AA,DG1 1                           ,4812,3067,56,202,1745
5809AB,DG1 2                           ,2126,1225,19,141,901
5809AC,DG1 3                           ,4712,3233,33,131,1479
5809AD,DG1 4                           ,8748,5885,72,224,2863
5809AE,DG2 7                           ,4036,2338,25,142,1698
5809AF,DG2 8                           ,2036,1255,15,66,781
5809AG,DG2 9                           ,5327,3272,76,344,2055
5809AH,DG2 0                           ,6061,3639,90,469,2422
5809AJ,DG3 4                           ,1710,946,13,59,764
5809AK,DG3 5                           ,2190,1229,11,73,961
5809AL,DG4 6                           ,3945,2217,88,360,1728
5809AM,DG111                           ,0,0,0,0,0
5809AQ,ML126                           ,0,0,0,0,0
5810AA,DG2 8                           ,969,567,5,25,402
5810AD,DG3 4                           ,0,0,0,0,0
5810AE,DG5 4                           ,4404,2431,42,162,1973
5810AF,DG6 4                           ,4347,2406,18,134,1941
5810AG,DG7 1                           ,4401,2551,31,166,1850
5810AH,DG7 2                           ,1875,995,11,54,880
5810AJ,DG7 3                           ,3206,1776,19,146,1430
5811AC,DG8 6                           ,3485,1841,50,188,1644
5811AD,DG8 7                           ,1067,562,21,73,505
5811AE,DG8 8                           ,1958,1058,31,190,900
5811AF,DG8 9                           ,2499,1352,43,149,1147
5811AG,DG8 0                           ,1593,924,26,64,669
5811AH,DG9 7                           ,5104,3020,157,442,2084
5811AJ,DG9 8                           ,3447,1947,47,148,1500
5811AK,DG9 9                           ,1922,1097,33,118,825
5811AL,DG9 0                           ,3156,1835,58,183,1321
5912AA,FK103                           ,0,0,0,0,0
5912AB,FK104                           ,2716,1725,31,165,991
5912AE,KY3 0                           ,1395,800,9,58,595
5912AF,KY4 8                           ,4554,2608,55,257,1946
5912AG,KY4 9                           ,6794,4056,97,500,2738
5912AH,KY4 0                           ,4369,2472,73,340,1897
5912AJ,KY5 8                           ,4882,2508,75,537,2374
5912AK,KY5 9                           ,5629,3048,82,378,2581
5912AM,KY111                           ,5559,3626,75,373,1933
5912AN,KY112                           ,10168,6729,171,491,3439
5912AP,KY113                           ,2764,1612,24,125,1152
5912AQ,KY114                           ,11985,7125,198,838,4860
5912AR,KY115                           ,10246,7354,107,326,2892
5912AS,KY127                           ,4274,2781,49,151,1493
5912AT,KY128                           ,8199,5279,97,393,2920
5912AU,KY129                           ,8617,5415,95,464,3202
5912AW,KY120                           ,7653,4444,67,333,3209
5913AA,KY1 1                           ,4686,2622,64,330,2064
5913AB,KY1 2                           ,5798,3141,86,529,2657
5913AC,KY1 3                           ,4250,2268,53,330,1982
5913AD,KY1 4                           ,3706,2050,47,229,1656
5913AE,KY2 5                           ,9517,5544,93,491,3973
5913AF,KY2 6                           ,14587,9447,237,911,5140
5913AG,KY3 9                           ,5191,3084,60,210,2107
5913AH,KY3 0                           ,2167,1227,29,170,940
5913AK,KY5 0                           ,5655,3032,73,437,2623
5913AL,KY6 1                           ,4104,2716,79,296,1388
5913AM,KY6 2                           ,7523,5349,118,557,2174
5913AN,KY6 3                           ,4077,2604,53,187,1473
5913AP,KY7 4                           ,7478,5045,144,490,2433
5913AQ,KY7 5                           ,3890,2403,59,205,1487
5913AR,KY7 6                           ,8282,5168,122,479,3114
5913AS,KY8 1                           ,4218,2247,70,395,1971
5913AT,KY8 2                           ,4509,2466,86,453,2043
5913AU,KY8 3                           ,4892,2662,65,409,2230
5913AW,KY8 4                           ,5016,2699,50,303,2317
5913AX,KY8 5                           ,6911,4226,93,490,2685
5914AA,DD6 8                           ,4319,2603,21,112,1716
5914AB,DD6 9                           ,2741,1649,17,119,1092
5914AE,KY7 7                           ,5234,3286,42,189,1948
5914AF,KY8 5                           ,0,0,0,0,0
5914AG,KY8 6                           ,2077,1079,9,54,998
5914AH,KY9 1                           ,2083,1136,9,80,947
5914AJ,KY102                           ,2759,1510,13,111,1249
5914AK,KY103                           ,4153,2269,33,169,1884
5914AL,KY137                           ,0,0,0,0,0
5914AM,KY146                           ,2064,1269,12,78,795
5914AN,KY147                           ,2973,1871,24,112,1102
5914AP,KY154                           ,4797,2793,43,172,2004
5914AQ,KY155                           ,5779,3344,45,176,2435
5914AR,KY168                           ,7601,4376,66,230,3225
5914AS,KY169                           ,3649,1671,21,89,1978
5914AT,KY160                           ,3962,2934,25,108,1028
6015AA,AB1 1                           ,4280,2802,24,174,1478
6015AB,AB1 2                           ,5240,3798,34,205,1442
6015AC,AB1 3                           ,7869,5185,40,434,2684
6015AD,AB1 4                           ,5455,4271,27,155,1184
6015AE,AB1 5                           ,7217,4644,29,211,2573
6015AF,AB1 6                           ,11429,7550,31,248,3879
6015AG,AB1 7                           ,10611,6035,33,222,4576
6015AH,AB1 8                           ,4568,2705,13,60,1863
6015AJ,AB1 9                           ,5434,3091,11,82,2343
6015AK,AB1 0                           ,5799,3774,17,109,2025
6015AL,AB2 1                           ,8734,4769,41,394,3965
6015AM,AB2 2                           ,11091,6509,61,649,4582
6015AN,AB2 3                           ,8356,5532,47,404,2824
6015AP,AB2 4                           ,10772,6937,37,210,3835
6015AQ,AB2 5                           ,11844,6957,39,363,4887
6015AR,AB2 6                           ,12278,7288,34,330,4990
6015AS,AB2 7                           ,8550,5599,44,578,2951
6015AT,AB228                           ,11622,9095,50,149,2527
6015AU,AB2 9                           ,6822,4617,19,128,2205
6015AW,AB2 0                           ,5465,4036,31,112,1429
6015AZ,AB238                           ,4609,3393,13,77,1216
6016AA,AB451                           ,3354,1970,36,128,1384
6016AB,AB452                           ,3929,2069,30,133,1860
6016AC,AB453                           ,1966,1190,12,66,776
6016AD,AB434                           ,6320,3838,51,259,2482
6016AE,AB435                           ,11971,7295,111,536,4676
6016AF,AB426                           ,13655,8802,100,647,4853
6016AG,AB427                           ,6284,4253,64,198,2031
6016AH,AB428                           ,5361,3385,31,140,1976
6016AJ,AB418                           ,0,0,0,0,0
6016AK,AB410                           ,0,0,0,0,0
6016AM,AB545                           ,1294,750,8,35,544
6016AN,AB546                           ,0,0,0,0,0
6016AP,AB537                           ,5506,3444,32,146,2062
6016AQ,AB538                           ,1968,1309,6,42,659
6016AS,AB510                           ,0,0,0,0,0
6016AT,AB441                           ,3093,1843,16,131,1250
6016AU,AB536                           ,838,516,10,21,322
6016AW,AB518                           ,1127,766,8,16,361
6017AA,AB1 8                           ,0,0,0,0,0
6017AC,AB2 0                           ,3931,2631,15,64,1300
6017AE,AB314                           ,0,0,0,0,0
6017AF,AB326                           ,6912,5194,27,108,1718
6017AG,AB517                           ,2206,1541,10,21,665
6017AH,AB338                           ,3086,1950,11,47,1136
6017AL,AB419                           ,6413,4409,31,121,2004
6017AM,AB410                           ,5117,3651,17,104,1466
6017AN,AB553                           ,0,0,0,0,0
6017AP,AB544                           ,2209,1397,15,77,812
6017AQ,AB545                           ,4420,2584,40,141,1836
6017AR,AB526                           ,2729,1720,15,64,1009
6017AS,AB518                           ,0,0,0,0,0
6017AT,AB519                           ,11953,7895,41,247,4058
6017AU,AB510                           ,5470,3618,24,74,1852
6017AW,AB238                           ,2741,2060,10,44,681
6017AX,AB327                           ,0,0,0,0,0
6017AY,AB368                           ,0,0,0,0,0
6017AZ,AB418                           ,1408,1015,8,36,393
6017BC,AB546                           ,0,0,0,0,0
6018AA,AB1 4                           ,5940,4615,13,124,1325
6018AB,AB1 5                           ,0,0,0,0,0
6018AC,AB1 0                           ,0,0,0,0,0
6018AD,AB301                           ,4784,3185,111,100,1599
6018AE,AB3 2                           ,11179,7523,40,212,3656
6018AF,AB313                           ,7083,4550,25,105,2533
6018AG,AB314                           ,2822,1702,9,44,1120
6018AH,AB345                           ,3372,1998,12,67,1374
6018AK,AB338                           ,0,0,0,0,0
6018AL,DD9 7                           ,0,0,0,0,0
6018AM,DD100                           ,3875,2356,31,100,1519
6018AN,AB344                           ,0,0,0,0,0
6018AP,AB355                           ,2181,1297,5,37,884
6019AA,AB389                           ,1552,974,6,44,578
6019AC,AB561                           ,6264,3559,52,257,2705
6019AD,AB562                           ,5081,2693,52,170,2388
6019AE,AB553                           ,5969,3641,104,282,2328
6019AF,AB554                           ,1817,1135,18,81,682
6019AG,AB545                           ,0,0,0,0,0
6019AH,IV301                           ,4240,2283,25,135,1957
6019AJ,IV302                           ,8311,5107,74,333,3204
6019AK,IV303                           ,9562,6380,124,383,3182
6019AL,IV316                           ,5686,3758,69,225,1928
6019AM,IV327                           ,3553,2098,26,128,1455
6019AN,AB387                           ,1698,1066,19,81,632
6019AP,AB379                           ,1054,672,11,45,382
6019AQ,AB544                           ,0,0,0,0,0
6019AR,IV360                           ,11336,7230,108,570,4106
6120AB,PH191                           ,0,0,0,0,0
6120AC,PH201                           ,1212,745,11,44,467
6120AD,PH211                           ,1523,939,9,45,584
6120AE,PH221                           ,1994,1538,12,127,456
6120AF,PH233                           ,0,0,0,0,0
6120AG,PH243                           ,0,0,0,0,0
6120AH,PH253                           ,1480,983,12,71,497
6120AJ,PH263                           ,2716,1579,10,114,1137
6121AA,KW1 4                           ,4286,2694,62,293,1592
6121AB,KW1 5                           ,4548,2808,81,329,1740
6121AC,KW2 6                           ,0,0,0,0,0
6121AD,KW3 6                           ,0,0,0,0,0
6121AE,KW5 6                           ,0,0,0,0,0
6121AF,KW6 6                           ,0,0,0,0,0
6121AG,KW7 6                           ,1439,796,17,123,643
6121AH,KW126                           ,1157,717,11,33,440
6121AJ,KW147                           ,5184,3385,65,269,1799
6121AK,KW148                           ,4313,2662,75,235,1651
6122AA,IV1 1                           ,0,0,0,0,0
6122AB,IV1 2                           ,10324,7222,79,452,3102
6122AC,IV2 3                           ,8795,6023,92,340,2772
6122AD,IV2 4                           ,9005,5685,75,365,3320
6122AE,IV3 5                           ,6266,3527,51,332,2739
6122AF,IV3 6                           ,10787,7050,146,707,3737
6122AG,IV4 7                           ,3242,2015,27,155,1227
6122AH,IV5 7                           ,0,0,0,0,0
6122AJ,IV137                           ,0,0,0,0,0
6122AK,PH324                           ,0,0,0,0,0
6122AL,PH354                           ,879,503,2,24,376
6123AB,PA345                           ,0,0,0,0,0
6123AC,PA384                           ,0,0,0,0,0
6123AD,PA394                           ,1023,606,7,50,417
6123AE,PA404                           ,865,472,15,54,393
6123AG,PH314                           ,0,0,0,0,0
6123AH,PH336                           ,5180,3444,34,306,1736
6123AJ,PH337                           ,4065,2738,37,235,1327
6123AK,PH344                           ,0,0,0,0,0
6123AL,PH354                           ,1238,817,6,43,421
6123AM,PH364                           ,1099,665,8,73,434
6123AN,PH374                           ,0,0,0,0,0
6123AP,PH384                           ,0,0,0,0,0
6123AQ,PH394                           ,0,0,0,0,0
6123AR,PH404                           ,0,0,0,0,0
6123AS,PH414                           ,757,497,9,52,260
6123AT,PH424                           ,866,550,9,66,316
6124AA,IV1 2                           ,0,0,0,0,0
6124AB,IV124                           ,3865,2250,19,135,1615
6124AC,IV125                           ,4560,2688,41,232,1872
6125AA,IV1 1                           ,1598,962,19,47,636
6125AB,IV4 7                           ,0,0,0,0,0
6125AC,IV6 7                           ,2993,1834,26,138,1159
6125AD,IV7 8                           ,3531,2192,22,145,1339
6125AE,IV8 8                           ,0,0,0,0,0
6125AF,IV9 8                           ,867,510,4,32,357
6125AG,IV108                           ,2184,1184,29,99,1000
6125AH,IV118                           ,0,0,0,0,0
6125AJ,IV149                           ,1469,880,23,76,589
6125AK,IV159                           ,4104,2529,55,185,1575
6125AL,IV169                           ,1180,744,11,56,436
6125AM,IV170                           ,4509,2728,112,436,1781
6125AN,IV180                           ,4499,2819,73,308,1680
6125AP,IV191                           ,3695,2178,59,200,1517
6125AQ,IV201                           ,2263,1303,47,172,960
6125AR,IV212                           ,838,484,4,34,354
6125AS,IV222                           ,1607,932,12,76,675
6125AT,IV232                           ,0,0,0,0,0
6125AW,IV262                           ,1573,1058,10,54,515
6125AY,IV548                           ,981,574,5,46,407
6125SS,SHIPPING                        ,0,0,0,0,0
6126AC,IV408                           ,2223,1382,25,105,841
6126AD,IV418                           ,0,0,0,0,0
6126AE,IV428                           ,0,0,0,0,0
6126AF,IV438                           ,0,0,0,0,0
6126AG,IV448                           ,0,0,0,0,0
6126AH,IV458                           ,0,0,0,0,0
6126AJ,IV468                           ,1152,716,10,76,436
6126AK,IV478                           ,0,0,0,0,0
6126AL,IV488                           ,0,0,0,0,0
6126AM,IV499                           ,1170,688,6,71,482
6126AN,IV519                           ,3525,2059,50,189,1466
6126AP,IV528                           ,0,0,0,0,0
6126AQ,IV538                           ,0,0,0,0,0
6126AR,IV558                           ,1156,632,21,81,524
6126AS,IV568                           ,0,0,0,0,0
6127AA,IV243                           ,1087,580,5,66,507
6127AB,IV253                           ,1654,908,15,70,746
6127AC,IV274                           ,3022,1815,16,208,1207
6127AD,IV283                           ,0,0,0,0,0
6127AE,KW8 6                           ,1077,557,5,71,520
6127AF,KW9 6                           ,1474,828,14,104,646
6127AG,KW106                           ,1312,785,11,57,527
6127AH,KW116                           ,0,0,0,0,0
6127AJ,KW136                           ,0,0,0,0,0
6127AK,KW147                           ,980,548,8,92,432
6228AA,EH216                           ,7929,5016,26,260,2913
6228AB,EH217                           ,5520,3275,41,238,2245
6228AC,EH218                           ,4610,2851,49,370,1759
6228AD,EH222                           ,0,0,0,0,0
6228AE,EH312                           ,1940,974,5,46,966
6228AF,EH329                           ,5641,3219,54,400,2422
6228AG,EH320                           ,6923,4283,30,221,2640
6228AH,EH331                           ,3593,2277,32,212,1316
6228AJ,EH332                           ,4903,3269,26,297,1634
6228AK,EH345                           ,1981,1227,10,53,754
6228AL,EH355                           ,1781,1158,20,77,623
6228AM,EH365                           ,0,0,0,0,0
6228AP,EH394                           ,4394,2206,17,136,2188
6228AQ,EH395                           ,1814,1097,4,57,717
6228AR,EH403                           ,1354,776,12,47,578
6228AS,EH413                           ,4265,2617,20,157,1648
6228AT,EH414                           ,4792,3159,20,198,1633
6228AU,EH421                           ,6465,3938,37,355,2527
6228AX,TD135                           ,0,0,0,0,0
6229AA,EH1 1                           ,1456,876,15,169,580
6229AB,EH1 2                           ,1534,964,17,140,570
6229AC,EH1 3                           ,1132,834,4,118,298
6229AD,EH2 1                           ,0,0,0,0,0
6229AE,EH2 2                           ,0,0,0,0,0
6229AF,EH2 3                           ,0,0,0,0,0
6229AG,EH2 4                           ,0,0,0,0,0
6229AH,EH3 5                           ,5351,3416,23,219,1935
6229AJ,EH3 6                           ,4761,3270,31,309,1491
6229AK,EH3 7                           ,1463,976,10,97,487
6229AL,EH3 8                           ,1481,1028,22,126,453
6229AM,EH3 9                           ,4667,3151,41,342,1516
6229AN,EH4 1                           ,5471,3528,15,206,1943
6229AP,EH4 2                           ,7879,4456,48,290,3423
6229AQ,EH4 3                           ,4552,2498,15,97,2054
6229AR,EH4 4                           ,7783,4990,108,1189,2793
6229AS,EH4 5                           ,3668,2210,23,104,1458
6229AT,EH4 6                           ,4485,2578,14,89,1907
6229AU,EH4 7                           ,6402,3482,36,262,2920
6229AW,EH4 8                           ,2315,1478,6,53,837
6229AX,EH5 1                           ,3760,1968,33,372,1792
6229AY,EH5 2                           ,4822,3031,23,181,1791
6229AZ,EH5 3                           ,4638,2780,11,139,1858
6229BA,EH6 4                           ,6722,4303,48,425,2419
6229BB,EH6 5                           ,4088,2758,50,341,1330
6229BC,EH6 6                           ,3071,2057,23,330,1014
6229BD,EH6 7                           ,2601,1603,17,147,998
6229BE,EH6 8                           ,7490,4956,70,446,2534
6229BF,EH7 4                           ,5782,3915,39,380,1867
6229BG,EH7 5                           ,8454,5979,66,536,2475
6229BH,EH7 6                           ,9465,5082,45,513,4383
6229BJ,EH8 7                           ,9080,5765,44,352,3315
6229BK,EH8 8                           ,2644,1487,12,155,1157
6229BL,EH8 9                           ,5723,3377,60,516,2346
6229BM,EH9 1                           ,8540,5395,59,479,3145
6229BN,EH9 2                           ,5185,2676,14,153,2509
6229BP,EH9 3                           ,2633,1340,10,69,1293
6229BQ,EH104                           ,7439,4559,42,334,2880
6229BR,EH105                           ,7547,4133,34,192,3414
6229BS,EH106                           ,6551,4030,24,125,2521
6229BT,EH107                           ,3362,2278,7,82,1084
6229BU,EH111                           ,9264,6757,46,466,2507
6229BW,EH112                           ,6178,4324,30,366,1854
6229BX,EH113                           ,7738,3855,74,539,3883
6229BY,EH114                           ,6375,4263,61,399,2112
6229BZ,EH125                           ,5343,3232,15,189,2111
6229CA,EH126                           ,4154,2354,12,93,1800
6229CB,EH127                           ,8022,4958,24,184,3064
6229CC,EH128                           ,9798,6359,47,279,3439
6229CD,EH129                           ,2580,1792,9,82,788
6229CE,EH120                           ,0,0,0,0,0
6229CF,EH139                           ,6634,3958,37,342,2676
6229CG,EH130                           ,4941,2932,13,83,2009
6229CH,EH141                           ,6571,3824,20,174,2747
6229CJ,EH142                           ,6568,4069,84,489,2499
6229CK,EH143                           ,4823,3403,101,577,1420
6229CL,EH144                           ,0,0,0,0,0
6229CM,EH145                           ,7421,4827,30,175,2594
6229CN,EH146                           ,0,0,0,0,0
6229CP,EH147                           ,3763,2477,14,73,1286
6229CQ,EH151                           ,5297,3321,25,199,1976
6229CR,EH152                           ,4852,2843,31,196,2009
6229CS,EH153                           ,6128,3753,60,407,2375
6229CT,EH164                           ,5421,2934,138,1010,2487
6229CU,EH165                           ,7478,3899,48,324,3579
6229CW,EH166                           ,8612,4914,50,403,3698
6229CX,EH177                           ,6313,3894,47,407,2419
6229CY,EH178                           ,7097,4370,74,491,2727
6229DA,EH209                           ,0,0,0,0,0
6229DC,EH218                           ,0,0,0,0,0
6229DE,EH278                           ,0,0,0,0,0
6229DF,EH288                           ,2552,1768,18,97,784
6229DG,EH299                           ,2311,1635,14,95,676
6229DH,EH309                           ,7191,5223,49,276,1968
6230AA,EH107                           ,0,0,0,0,0
6230AD,EH181                           ,1818,1304,12,61,514
6230AE,EH192                           ,4813,3040,35,239,1773
6230AF,EH193                           ,4401,2960,40,210,1441
6230AG,EH209                           ,5001,3147,35,304,1854
6230AJ,EH221                           ,4605,2770,41,260,1835
6230AK,EH222                           ,4585,2926,43,346,1659
6230AL,EH223                           ,2384,1525,11,44,859
6230AM,EH224                           ,4739,2822,34,289,1917
6230AN,EH225                           ,5168,3481,60,460,1687
6230AP,EH234                           ,5526,3284,54,346,2242
6230AQ,EH249                           ,1056,590,9,93,466
6230AR,EH259                           ,3003,1929,10,133,1074
6230AS,EH268                           ,4814,3271,31,225,1543
6230AT,EH269                           ,3487,2507,14,86,980
6230AU,EH260                           ,5384,3880,40,225,1504
6230AW,EH375                           ,1297,783,5,51,514
6231AA,EH278                           ,1400,1009,19,63,391
6231AB,EH309                           ,0,0,0,0,0
6231AC,EH477                           ,4660,2976,51,381,1684
6231AD,EH478                           ,5788,4077,68,438,1711
6231AE,EH479                           ,3791,2348,42,324,1443
6231AF,EH470                           ,6091,3834,77,502,2257
6231AG,EH481                           ,5093,3395,52,301,1698
6231AH,EH482                           ,5757,3608,38,394,2149
6231AJ,EH483                           ,6786,4226,69,434,2560
6231AK,EH484                           ,3766,2339,47,243,1427
6231AL,EH496                           ,5489,3636,43,222,1853
6231AM,EH497                           ,5410,3732,29,157,1678
6231AN,EH525                           ,5456,3568,30,218,1888
6231AP,EH526                           ,7902,5038,60,503,2864
6231AQ,EH530                           ,7757,5848,41,294,1909
6231AR,EH545                           ,5402,3767,70,479,1635
6231AS,EH546                           ,12483,8946,217,947,3537
6231AT,EH547                           ,983,771,4,18,212
6231AU,EH548                           ,9810,6959,149,710,2851
6231AW,EH549                           ,2208,1791,7,59,417
6231AX,EH558                           ,5841,3667,51,332,2174
6231AY,FK1 2                           ,0,0,0,0,0
6231BA,ML7 5                           ,0,0,0,0,0
6332AA,FK208                           ,0,0,0,0,0
6332AB,G83 7                           ,0,0,0,0,0
6332AC,PA209                           ,2810,1424,20,166,1386
6332AD,PA200                           ,3276,1594,20,211,1682
6332AE,PA212                           ,0,0,0,0,0
6332AF,PA223                           ,1033,487,4,43,546
6332AG,PA237                           ,4609,2619,69,222,1990
6332AH,PA238                           ,6773,3836,122,366,2937
6332AJ,PA248                           ,0,0,0,0,0
6332AK,PA258                           ,0,0,0,0,0
6332AL,PA268                           ,0,0,0,0,0
6332AM,PA278                           ,0,0,0,0,0
6332AN,PA286                           ,6929,4240,80,401,2689
6332AP,PA296                           ,2105,1256,25,100,849
6332AQ,PA308                           ,1154,712,19,47,442
6332AR,PA318                           ,3666,2262,40,155,1404
6332AS,PA328                           ,1026,640,13,46,386
6332AT,PA331                           ,1417,869,8,68,548
6332AU,PA344                           ,5016,3240,50,194,1776
6332AW,PA345                           ,2854,1817,18,112,1037
6332AX,PA351                           ,1270,762,12,45,508
6332AZ,PA371                           ,2102,1249,8,90,853
6332BA,PA384                           ,0,0,0,0,0
6332BB,PA417                           ,0,0,0,0,0
6332BC,PA427                           ,898,530,18,103,368
6332BD,PA437                           ,0,0,0,0,0
6332BE,PA447                           ,0,0,0,0,0
6332BF,PA457                           ,0,0,0,0,0
6332BG,PA467                           ,0,0,0,0,0
6332BH,PA477                           ,0,0,0,0,0
6332BJ,PA487                           ,0,0,0,0,0
6332BK,PA497                           ,0,0,0,0,0
6332BL,PA607                           ,0,0,0,0,0
6332BM,PA617                           ,2127,1273,45,107,854
6332BN,PA626                           ,0,0,0,0,0
6332BQ,PA646                           ,0,0,0,0,0
6332BR,PA656                           ,0,0,0,0,0
6332BS,PA666                           ,0,0,0,0,0
6332BT,PA676                           ,0,0,0,0,0
6332BX,PA706                           ,0,0,0,0,0
6332BZ,PA726                           ,0,0,0,0,0
6332CA,PA736                           ,0,0,0,0,0
6332CC,PA756                           ,967,585,12,27,382
6332CD,PA766                           ,837,498,19,35,339
6332CE,PA776                           ,0,0,0,0,0
6332CF,PA786                           ,1208,682,6,52,526
6333AA,G61 1                           ,5065,3195,26,137,1870
6333AB,G61 2                           ,5383,3240,22,136,2143
6333AC,G61 3                           ,5222,3195,20,119,2027
6333AD,G61 4                           ,6170,4117,37,180,2053
6333AE,G62 6                           ,3063,1565,11,73,1498
6333AF,G62 7                           ,5075,3245,52,246,1830
6333AG,G62 8                           ,2116,1131,6,56,985
6334AC,G60 5                           ,2368,1475,21,128,893
6334AD,G81 1                           ,5031,2777,74,470,2254
6334AE,G81 2                           ,6059,3348,88,551,2711
6334AF,G81 3                           ,6224,3195,62,436,3029
6334AG,G81 4                           ,6015,3003,87,528,3012
6334AH,G81 5                           ,4660,2524,87,465,2136
6334AJ,G81 6                           ,5876,4037,67,370,1839
6335AE,G65 9                           ,5109,3175,76,319,1934
6335AF,G65 0                           ,4740,2657,51,277,2083
6335AG,G67 1                           ,4541,2746,53,253,1795
6335AH,G67 2                           ,10864,7361,179,962,3503
6335AJ,G67 3                           ,8004,5713,133,508,2291
6335AK,G67 4                           ,8478,6074,141,451,2404
6335AL,G68 9                           ,5694,3943,70,279,1751
6335AM,G68 0                           ,788,602,3,22,186
6336AD,KA4 8                           ,0,0,0,0,0
6336AE,KA5 5                           ,1673,1017,16,75,656
6336AF,KA5 6                           ,4405,2553,78,355,1852
6336AG,KA6 6                           ,1262,772,33,96,490
6336AH,KA6 7                           ,7732,4094,196,751,3638
6336AJ,KA181                           ,5827,3472,124,468,2355
6336AK,KA182                           ,4382,2366,89,424,2016
6336AL,KA183                           ,4654,2430,114,461,2224
6336AM,KA184                           ,3678,1954,73,423,1724
6337AB,KA2 0                           ,0,0,0,0,0
6337AC,KA3 2                           ,0,0,0,0,0
6337AF,KA111                           ,9110,6316,174,664,2794
6337AG,KA112                           ,834,571,10,28,263
6337AH,KA113                           ,1043,555,19,109,488
6337AJ,KA114                           ,3435,2329,50,159,1106
6337AK,KA115                           ,0,0,0,0,0
6337AL,KA128                           ,3278,1813,52,267,1465
6337AM,KA129                           ,5806,3669,118,521,2137
6337AN,KA120                           ,7139,3993,125,539,3146
6337AP,KA136                           ,7349,4743,121,548,2606
6337AQ,KA137                           ,5032,2962,82,387,2070
6337AR,KA143                           ,0,0,0,0,0
6337AS,KA151                           ,2931,1919,43,153,1012
6337AT,KA152                           ,2821,1700,32,155,1121
6337AU,KA203                           ,4332,2364,76,395,1968
6337AW,KA204                           ,3585,1942,91,331,1643
6337AX,KA215                           ,5349,2672,59,398,2677
6337AY,KA216                           ,4149,2264,69,386,1885
6337AZ,KA227                           ,5094,2904,109,412,2190
6337BA,KA228                           ,3223,1798,63,277,1425
6337BB,KA239                           ,3876,2130,45,196,1746
6337BC,KA244                           ,2952,1663,29,223,1289
6337BD,KA245                           ,2029,1337,27,122,692
6337BE,KA256                           ,3426,1991,57,343,1435
6337BF,KA257                           ,3154,1917,55,263,1237
6337BG,KA278                           ,3680,2041,13,170,1639
6337BH,KA280                           ,1212,535,8,63,677
6337BJ,KA290                           ,1224,671,7,37,553
6337BK,KA308                           ,4610,1991,23,119,2619
6337BL,KA309                           ,4936,2684,45,276,2252
6337BM,PA175                           ,1598,947,8,75,651
6338AA,G60 5                           ,0,0,0,0,0
6338AC,G82 1                           ,2507,1541,22,98,966
6338AD,G82 2                           ,5227,3083,38,268,2144
6338AE,G82 3                           ,4975,3224,68,443,1751
6338AF,G82 4                           ,3964,2188,52,400,1776
6338AG,G82 5                           ,4748,2920,75,366,1828
6338AH,G83 7                           ,0,0,0,0,0
6338AJ,G83 8                           ,7135,4578,96,558,2557
6338AK,G83 9                           ,7429,5349,105,621,2080
6338AL,G83 0                           ,5930,3484,66,421,2446
6338AM,G84 7                           ,5232,3208,36,249,2024
6338AN,G84 8                           ,5245,3089,40,147,2156
6338AP,G84 9                           ,3930,2546,45,92,1384
6338AQ,G84 0                           ,3738,2288,35,184,1450
6339AA,G72 8                           ,0,0,0,0,0
6339AB,G72 9                           ,0,0,0,0,0
6339AF,G74 1                           ,3211,1837,30,188,1374
6339AG,G74 2                           ,7437,5162,74,309,2275
6339AH,G74 3                           ,12030,7725,104,680,4305
6339AJ,G74 4                           ,5527,3478,47,284,2049
6339AK,G74 5                           ,0,0,0,0,0
6339AL,G75 8                           ,14411,10241,161,810,4170
6339AM,G75 9                           ,6371,4558,91,471,1813
6339AN,G75 0                           ,7436,4623,65,438,2813
6339AP,G76 8                           ,1929,1269,15,68,660
6339AQ,G76 9                           ,0,0,0,0,0
6339AU,ML106                           ,7382,4584,54,323,2798
6340AA,G44 3                           ,3827,2136,19,75,1691
6340AB,G46 6                           ,7332,4441,28,149,2891
6340AC,G46 7                           ,6035,3561,33,213,2474
6340AD,G46 8                           ,0,0,0,0,0
6340AE,G76 7                           ,6614,4360,23,151,2254
6340AF,G76 8                           ,4650,2943,20,174,1707
6340AG,G76 0                           ,3778,2406,29,116,1372
6340AH,G77 5                           ,7338,4400,29,183,2938
6340AJ,G77 6                           ,7649,5065,35,251,2584
6341AA,G1  1                           ,1764,1149,15,166,615
6341AB,G1  2                           ,0,0,0,0,0
6341AD,G1  4                           ,0,0,0,0,0
6341AE,G1  5                           ,0,0,0,0,0
6341AH,G2  3                           ,0,0,0,0,0
6341AJ,G2  4                           ,0,0,0,0,0
6341AL,G2  6                           ,0,0,0,0,0
6341AM,G2  7                           ,0,0,0,0,0
6341AN,G2  8                           ,0,0,0,0,0
6341AP,G3  6                           ,3326,1798,63,420,1528
6341AQ,G3  7                           ,1945,1280,61,227,665
6341AR,G3  8                           ,4614,2497,91,501,2117
6341AS,G4  9                           ,3400,1949,55,355,1451
6341AT,G4  0                           ,4959,1944,71,501,3015
6341AU,G5  8                           ,1700,827,16,258,873
6341AW,G5  9                           ,2324,1124,40,415,1200
6341AX,G5  0                           ,5475,2403,86,928,3072
6341AY,G11 5                           ,5231,3240,49,360,1991
6341AZ,G11 6                           ,2139,1288,29,187,851
6341BA,G11 7                           ,7624,4602,63,365,3022
6341BB,G12 8                           ,4253,2690,108,569,1563
6341BC,G12 9                           ,7100,4853,59,389,2247
6341BD,G12 0                           ,7547,4250,47,276,3297
6341BE,G13 1                           ,6161,3728,32,289,2433
6341BF,G13 2                           ,6829,2889,62,536,3940
6341BG,G13 3                           ,8888,3795,87,586,5093
6341BH,G13 4                           ,4741,2340,69,411,2401
6341BJ,G14 9                           ,7724,4212,65,535,3512
6341BK,G14 0                           ,5870,3243,102,712,2627
6341BL,G15 6                           ,5242,2469,46,363,2773
6341BM,G15 7                           ,6778,3406,167,1246,3372
6341BN,G15 8                           ,3979,1906,100,663,2073
6341BP,G20 6                           ,5182,3267,75,399,1915
6341BQ,G20 7                           ,3012,1522,55,437,1490
6341BR,G20 8                           ,6615,3366,73,833,3249
6341BS,G20 9                           ,3700,1816,61,606,1884
6341BT,G20 0                           ,5890,3257,72,708,2633
6341BU,G21 1                           ,5940,3130,101,841,2810
6341BW,G21 2                           ,4962,2236,104,845,2726
6341BX,G21 3                           ,9437,5099,176,1202,4338
6341BY,G21 4                           ,6361,3402,104,951,2959
6341BZ,G22 5                           ,5716,2766,111,1181,2950
6341CA,G22 6                           ,6124,2582,83,620,3542
6341CB,G22 7                           ,6932,3612,86,1020,3320
6341CC,G23 5                           ,5844,3758,80,480,2086
6341CD,G31 1                           ,3317,1626,41,531,1691
6341CE,G31 2                           ,5872,3757,77,542,2115
6341CF,G31 3                           ,5759,3208,70,770,2551
6341CG,G31 4                           ,4516,1955,60,757,2561
6341CH,G31 5                           ,2034,1061,18,335,973
6341CJ,G32 6                           ,6917,3110,76,691,3807
6341CK,G32 7                           ,5742,2953,69,667,2789
6341CL,G32 8                           ,6763,3873,88,648,2890
6341CM,G32 9                           ,6149,3189,49,321,2960
6341CN,G32 0                           ,5425,3289,50,360,2136
6341CP,G33 1                           ,5105,3169,77,690,1936
6341CQ,G33 2                           ,5372,2211,46,299,3161
6341CR,G33 3                           ,7289,3641,188,1174,3648
6341CS,G33 4                           ,6651,3530,202,1185,3121
6341CT,G33 5                           ,5121,2801,113,808,2320
6341CU,G33 6                           ,0,0,0,0,0
6341CW,G34 9                           ,4879,2651,148,1042,2228
6341CX,G34 0                           ,5096,2798,95,858,2298
6341CY,G40 1                           ,1952,1147,16,164,805
6341CZ,G40 2                           ,2171,1028,25,343,1143
6341DA,G40 3                           ,2776,1274,45,502,1502
6341DB,G40 4                           ,2946,1405,50,535,1541
6341DC,G41 1                           ,1042,633,14,135,409
6341DD,G41 2                           ,6072,3905,69,571,2167
6341DE,G41 3                           ,8985,5527,69,451,3458
6341DF,G41 4                           ,3954,2231,21,122,1723
6341DG,G41 5                           ,4633,2410,56,293,2223
6341DH,G42 7                           ,3990,2109,50,419,1881
6341DJ,G42 8                           ,8338,4952,110,793,3386
6341DK,G42 9                           ,7286,4543,73,526,2743
6341DL,G42 0                           ,5409,2456,86,655,2953
6341DM,G43 1                           ,6491,2946,55,488,3545
6341DN,G43 2                           ,8446,4557,49,346,3889
6341DP,G44 3                           ,3171,1853,20,94,1318
6341DQ,G44 4                           ,7886,5083,43,385,2803
6341DR,G44 5                           ,8541,5861,68,353,2680
6341DS,G45 9                           ,8721,3991,118,1230,4730
6341DT,G45 0                           ,4679,2397,123,898,2282
6341DU,G46 7                           ,0,0,0,0,0
6341DW,G46 8                           ,7057,4160,102,979,2897
6341DX,G51 1                           ,4447,2739,67,436,1708
6341DY,G51 2                           ,6335,3255,96,1009,3080
6341DZ,G51 3                           ,4157,2292,86,667,1865
6341EA,G51 4                           ,7069,3750,87,757,3319
6341EB,G52 1                           ,7160,3144,53,491,4016
6341EC,G52 2                           ,9000,4785,83,634,4215
6341ED,G52 3                           ,7175,4044,56,383,3131
6341EE,G52 4                           ,3540,1742,51,423,1798
6341EF,G53 5                           ,8505,4601,167,1141,3904
6341EG,G53 6                           ,6713,3652,136,1003,3061
6341EH,G53 7                           ,8447,4774,117,904,3673
6341EJ,G61 1                           ,0,0,0,0,0
6341EL,G64 1                           ,0,0,0,0,0
6341EN,G69 6                           ,5907,3893,53,268,2014
6341EP,G69 7                           ,6717,4096,74,514,2621
6341EQ,G69 8                           ,1099,559,4,34,540
6341ER,G71 7                           ,0,0,0,0,0
6341ES,G72 7                           ,6505,3622,96,630,2883
6341ET,G72 8                           ,9555,5933,97,846,3622
6341EW,G73 1                           ,3110,1648,23,329,1462
6341EX,G73 2                           ,6433,3716,43,360,2717
6341EY,G73 3                           ,6980,3804,42,298,3176
6341EZ,G73 4                           ,6849,3833,81,550,3016
6341FA,G73 5                           ,5251,2897,44,417,2354
6341FB,G76 9                           ,962,550,5,34,412
6342AB,G71 7                           ,4061,2523,26,212,1538
6342AC,G71 8                           ,5393,3110,27,229,2283
6342AD,G72 9                           ,8322,5016,88,624,3306
6342AE,G72 0                           ,5946,3121,72,718,2825
6342AG,ML3 6                           ,4819,2437,26,313,2382
6342AH,ML3 7                           ,9394,5989,88,538,3405
6342AJ,ML3 8                           ,11012,7164,122,893,3848
6342AK,ML3 9                           ,10635,5801,74,804,4834
6342AL,ML3 0                           ,4368,2382,52,442,1986
6342AM,ML8 5                           ,0,0,0,0,0
6342AN,ML9 1                           ,5768,3238,64,437,2530
6342AP,ML9 2                           ,6944,4366,47,446,2578
6342AQ,ML9 3                           ,5864,3602,73,353,2262
6343AB,PA113                           ,0,0,0,0,0
6343AC,PA134                           ,4291,2370,21,116,1921
6343AD,PA145                           ,7670,4418,118,628,3252
6343AE,PA146                           ,7533,4366,166,1017,3167
6343AF,PA151                           ,1972,769,21,160,1203
6343AG,PA152                           ,4153,2195,93,586,1958
6343AH,PA153                           ,3079,1899,75,485,1180
6343AJ,PA154                           ,7178,3721,88,615,3457
6343AK,PA167                           ,7465,4095,97,722,3370
6343AL,PA168                           ,5319,3191,35,199,2128
6343AM,PA169                           ,3870,2021,42,266,1849
6343AN,PA160                           ,8002,4958,195,928,3044
6343AP,PA186                           ,1237,841,11,63,396
6343AQ,PA191                           ,9594,5777,83,438,3817
6344AC,KA1 1                           ,2497,1616,14,60,881
6344AD,KA1 2                           ,4315,2353,24,175,1962
6344AE,KA1 3                           ,6209,3474,82,359,2735
6344AF,KA1 4                           ,5748,3225,126,627,2523
6344AG,KA1 5                           ,3693,2076,53,230,1617
6344AH,KA2 9                           ,0,0,0,0,0
6344AJ,KA2 0                           ,2971,1970,57,165,1001
6344AK,KA3 1                           ,4631,2592,72,486,2039
6344AL,KA3 2                           ,6636,4256,114,616,2380
6344AM,KA3 3                           ,2438,1544,25,162,894
6344AN,KA3 4                           ,1092,636,10,46,456
6344AP,KA3 5                           ,3029,1888,42,138,1141
6344AQ,KA3 6                           ,2167,1373,26,138,794
6344AR,KA3 7                           ,7397,5117,122,493,2280
6344AS,KA4 8                           ,4446,2756,60,259,1690
6344AW,KA169                           ,2909,1782,42,185,1127
6344AX,KA170                           ,3162,2008,38,145,1154
6345AC,KA1 5                           ,1515,900,14,56,615
6345AD,KA2 9                           ,2158,1249,28,125,909
6345AE,KA5 5                           ,2027,1262,36,171,765
6345AF,KA6 5                           ,2919,1763,37,218,1156
6345AG,KA6 6                           ,2479,1421,24,84,1058
6345AJ,KA7 1                           ,1813,1107,32,185,706
6345AK,KA7 2                           ,5053,2504,47,140,2549
6345AL,KA7 3                           ,9149,5665,123,501,3484
6345AM,KA7 4                           ,7476,4289,38,171,3187
6345AN,KA8 8                           ,3338,1877,58,231,1461
6345AP,KA8 9                           ,6463,3681,108,552,2782
6345AQ,KA8 0                           ,6451,3293,102,499,3158
6345AR,KA9 1                           ,6381,3562,56,232,2819
6345AS,KA9 2                           ,5828,3412,46,209,2416
6345AT,KA106                           ,8234,4602,68,310,3632
6345AU,KA107                           ,4176,2717,47,162,1459
6345AX,KA197                           ,3597,2155,70,199,1442
6345AY,KA198                           ,2264,1436,41,132,828
6345AZ,KA269                           ,4532,2548,49,284,1984
6345BA,KA260                           ,5005,2849,56,378,2156
6346AB,EH467                           ,0,0,0,0,0
6346AC,EH558                           ,0,0,0,0,0
6346AE,ML8 4                           ,5570,3357,70,341,2213
6346AF,ML8 5                           ,8524,5606,92,397,2918
6346AH,ML117                           ,5786,3413,71,283,2373
6346AJ,ML118                           ,6480,3663,96,408,2817
6346AK,ML119                           ,7518,4640,72,459,2878
6346AL,ML110                           ,6219,3526,73,431,2693
6346AM,ML126                           ,5410,3275,42,188,2135
6347AC,G67 4                           ,0,0,0,0,0
6347AE,G69 7                           ,1827,958,26,160,869
6347AG,ML1 5                           ,0,0,0,0,0
6347AJ,ML5 1                           ,5718,3340,44,383,2378
6347AK,ML5 2                           ,7464,4131,104,706,3333
6347AL,ML5 3                           ,4053,2198,33,268,1855
6347AM,ML5 4                           ,8684,4910,90,850,3774
6347AN,ML5 5                           ,9855,5367,172,1059,4488
6347AP,ML6 6                           ,7396,4371,90,819,3025
6347AQ,ML6 7                           ,8023,4442,105,751,3581
6347AR,ML6 8                           ,8970,5458,145,903,3512
6347AS,ML6 9                           ,9334,5489,117,652,3845
6347AT,ML6 0                           ,7048,4331,69,653,2717
6347AU,ML7 4                           ,1328,695,19,101,633
6348AC,G71 5                           ,5611,3284,89,709,2327
6348AD,G71 6                           ,5780,3735,52,446,2045
6348AE,G71 7                           ,0,0,0,0,0
6348AG,ML1 1                           ,4954,2363,57,413,2591
6348AH,ML1 2                           ,7153,3836,78,527,3317
6348AJ,ML1 3                           ,10951,6615,165,961,4336
6348AK,ML1 4                           ,9026,5252,116,945,3774
6348AL,ML1 5                           ,7689,4365,93,629,3324
6348AM,ML2 7                           ,8324,4480,108,821,3844
6348AN,ML2 8                           ,10402,5909,147,775,4493
6348AP,ML2 9                           ,5034,2694,101,430,2340
6348AQ,ML2 0                           ,8271,4649,100,744,3622
6348AR,ML4 1                           ,5102,3110,55,474,1992
6348AS,ML4 2                           ,9021,5336,115,950,3685
6348AT,ML4 3                           ,3255,1709,34,256,1546
6348AW,ML7 4                           ,5270,2574,61,351,2696
6348AX,ML7 5                           ,6361,3471,81,485,2890
6349AC,G53 7                           ,0,0,0,0,0
6349AE,G78 1                           ,6166,3825,55,436,2341
6349AF,G78 2                           ,7290,4456,80,527,2834
6349AG,G78 3                           ,4278,2871,48,270,1407
6349AH,G78 4                           ,0,0,0,0,0
6349AJ,PA1 1                           ,4577,3194,56,418,1383
6349AK,PA1 2                           ,6079,3461,59,482,2618
6349AL,PA1 3                           ,7211,4063,30,193,3148
6349AM,PA2 6                           ,8181,4429,75,476,3752
6349AN,PA2 7                           ,5481,3110,47,306,2371
6349AP,PA2 8                           ,6434,3957,83,545,2477
6349AQ,PA2 9                           ,6010,4105,47,259,1905
6349AR,PA2 0                           ,5851,3580,87,612,2271
6349AS,PA3 1                           ,3549,1905,85,670,1644
6349AT,PA3 2                           ,3674,2205,48,404,1469
6349AU,PA3 3                           ,8071,5204,108,645,2867
6349AW,PA3 4                           ,5297,2825,71,445,2472
6349AX,PA4 8                           ,5547,3527,65,518,2020
6349AY,PA4 9                           ,3443,2030,43,188,1413
6349AZ,PA4 0                           ,8575,5690,89,340,2885
6349BA,PA5 8                           ,6903,3985,97,530,2918
6349BB,PA5 9                           ,5869,3546,85,391,2323
6349BC,PA5 0                           ,6614,4003,122,645,2611
6349BD,PA6 7                           ,4508,3151,29,105,1357
6349BE,PA7 5                           ,4643,2991,32,133,1652
6349BF,PA8 6                           ,5102,3340,48,219,1762
6349BG,PA8 7                           ,5130,3609,48,207,1521
6349BH,PA9 1                           ,1523,954,7,61,569
6349BJ,PA102                           ,3312,2023,37,136,1289
6349BK,PA113                           ,4154,2576,28,152,1578
6349BL,PA124                           ,2421,1494,18,127,927
6349BN,PA146                           ,777,526,2,23,251
6350AB,G33 6                           ,3528,2194,26,195,1334
6350AC,G62 6                           ,0,0,0,0,0
6350AF,G64 1                           ,9338,6521,72,423,2817
6350AG,G64 2                           ,4550,3002,27,164,1548
6350AH,G64 3                           ,4987,3265,33,150,1722
6350AJ,G64 4                           ,2347,1621,23,89,726
6350AK,G65 7                           ,3925,2096,32,197,1829
6350AL,G65 8                           ,3136,2191,33,112,945
6350AM,G65 9                           ,1168,654,27,102,514
6350AP,G66 1                           ,2859,1751,26,102,1108
6350AQ,G66 2                           ,6800,4138,103,528,2662
6350AR,G66 3                           ,6574,4241,46,223,2333
6350AS,G66 4                           ,5129,3237,45,201,1892
6350AT,G66 5                           ,3538,2414,18,88,1124
6350AU,G67 4                           ,0,0,0,0,0
6350AX,G69 8                           ,1340,807,17,120,533
6350AY,G69 9                           ,2752,1651,25,144,1101
6350AZ,G69 0                           ,4693,2908,77,334,1785
6451AA,AB301                           ,0,0,0,0,0
6451AC,DD5 3                           ,852,612,6,28,240
6451AE,DD7 6                           ,3730,2323,20,111,1407
6451AF,DD7 7                           ,5167,3279,54,239,1888
6451AG,DD8 1                           ,6630,4195,45,322,2435
6451AH,DD8 2                           ,5091,3139,47,204,1952
6451AJ,DD8 3                           ,4059,2478,34,133,1581
6451AK,DD8 4                           ,2896,1697,27,94,1199
6451AL,DD8 5                           ,3049,1811,18,140,1238
6451AM,DD9 6                           ,4232,2558,51,119,1674
6451AN,DD9 7                           ,4337,2704,38,184,1633
6451AP,DD108                           ,5827,3346,51,354,2481
6451AQ,DD109                           ,6410,3882,70,310,2528
6451AS,DD111                           ,4555,2633,71,436,1922
6451AT,DD112                           ,4297,2690,40,185,1607
6451AU,DD113                           ,3403,2029,37,154,1374
6451AW,DD114                           ,5381,3348,80,233,2033
6451AX,DD115                           ,4588,2729,76,343,1859
6451AY,PH118                           ,0,0,0,0,0
6451AZ,PH128                           ,831,531,7,28,300
6452AA,DD1 1                           ,0,0,0,0,0
6452AB,DD1 2                           ,2011,1249,29,233,762
6452AC,DD1 3                           ,0,0,0,0,0
6452AD,DD1 4                           ,1464,798,17,129,666
6452AE,DD1 5                           ,1950,1125,27,194,825
6452AF,DD2 1                           ,6243,3609,38,233,2634
6452AG,DD2 2                           ,7264,4271,74,394,2993
6452AH,DD2 3                           ,8582,4977,129,1114,3605
6452AJ,DD2 4                           ,10093,6210,136,864,3883
6452AK,DD2 5                           ,4848,2899,29,106,1949
6452AL,DD3 6                           ,6575,3365,42,403,3210
6452AM,DD3 7                           ,6422,3541,84,712,2881
6452AN,DD3 8                           ,6100,3488,34,274,2612
6452AP,DD3 9                           ,7091,4738,81,394,2353
6452AQ,DD3 0                           ,5634,3516,110,652,2118
6452AR,DD4 6                           ,5433,3443,62,476,1990
6452AS,DD4 7                           ,6672,3501,40,224,3171
6452AT,DD4 8                           ,9325,5135,173,1236,4190
6452AU,DD4 9                           ,9604,5963,147,923,3641
6452AW,DD4 0                           ,5876,4022,151,907,1854
6452AX,DD5 1                           ,4264,2326,27,139,1938
6452AY,DD5 2                           ,5815,3354,25,166,2461
6452AZ,DD5 3                           ,6164,4062,39,164,2102
6452BA,DD5 4                           ,6533,4061,30,174,2472
6452BD,PH149                           ,0,0,0,0,0
6453AB,FK147                           ,0,0,0,0,0
6453AC,FK159                           ,0,0,0,0,0
6453AD,FK150                           ,0,0,0,0,0
6453AF,FK218                           ,0,0,0,0,0
6453AG,KY4 0                           ,0,0,0,0,0
6453AJ,KY6 3                           ,0,0,0,0,0
6453AK,KY137                           ,7262,4633,44,255,2629
6453AL,KY146                           ,0,0,0,0,0
6453AN,PH1 1                           ,5684,3601,23,100,2083
6453AP,PH1 2                           ,8968,5740,85,608,3228
6453AQ,PH1 3                           ,7046,4724,58,273,2322
6453AR,PH1 4                           ,2910,1806,18,81,1104
6453AS,PH1 5                           ,5539,3402,70,386,2137
6453AT,PH2 6                           ,5588,3249,33,112,2339
6453AU,PH2 7                           ,6038,3488,33,147,2550
6453AW,PH2 8                           ,2862,1667,25,183,1195
6453AX,PH2 9                           ,4269,2692,20,93,1577
6453AY,PH2 0                           ,5893,3542,43,204,2351
6453AZ,PH3 1                           ,3801,2248,20,103,1553
6453BA,PH4 1                           ,928,612,8,34,316
6453BB,PH5 2                           ,1355,831,8,44,524
6453BC,PH6 2                           ,1705,750,12,44,955
6453BD,PH7 3                           ,4250,2480,28,154,1770
6453BE,PH7 4                           ,1889,1041,12,56,848
6453BF,PH8 0                           ,2409,1460,14,67,949
6453BG,PH9 0                           ,0,0,0,0,0
6453BH,PH106                           ,4816,2695,12,233,2121
6453BJ,PH107                           ,3081,1851,23,212,1230
6453BK,PH118                           ,2305,1359,18,93,946
6453BL,PH128                           ,0,0,0,0,0
6453BM,PH139                           ,3852,2432,24,91,1420
6453BN,PH149                           ,966,677,0,25,289
6453BP,PH152                           ,2608,1470,15,62,1138
6453BQ,PH165                           ,3161,1878,20,87,1283
6453BR,PH172                           ,0,0,0,0,0
6453BS,PH185                           ,827,536,9,13,291
6554AA,KW151                           ,5943,3756,57,166,2187
6554AB,KW163                           ,2944,1788,25,118,1156
6554AC,KW172                           ,6575,4047,71,230,2528
6655AA,ZE1 0                           ,6682,4526,70,195,2156
6655AB,ZE2 9                           ,10615,6925,149,341,3690
6655AC,ZE3 9                           ,0,0,0,0,0
6756AA,PA805                           ,980,575,11,97,405
6756AB,PA815                           ,1703,1064,26,143,639
6756AC,PA825                           ,1452,869,12,84,583
6756AD,PA833                           ,0,0,0,0,0
6756AE,PA843                           ,0,0,0,0,0
6756AF,PA853                           ,1823,920,34,149,903
6756AG,PA869                           ,3809,1987,53,287,1822
6756AH,PA860                           ,7485,4217,121,439,3268
6756AJ,PA872                           ,4747,2752,64,257,1995
6756AK,PA885                           ,1305,991,29,57,314
